times per minute	分あたり|回/分
kilometers	キロメートル
pounds	ポンド
meters per second	meters per second|メートル毎秒
feet	フィート
gallons	ガロン|gal
miles per hour	mph|マイル毎時
tons	トン
minute	分
miles	マイル
Kelvin	ケルビン (K)
meters	メートル
inch	インチ
feet per second	フィート毎秒|ft/s
watts	ワット (W)
degrees Fahrenheit	度華氏
floors	階数|階
pounds per square inch	psi|ポンド毎平方インチ
meters per second squared	m/s^2|メートル毎秒毎秒
inches	インチ
kiloPascals	kPa|キロパスカル
kilowatt-hours	kWh|キロワット時
percent	%|パーセント
kilopascals	kPa|キロパスカル
scale	"There are multiple possible meanings for ""scale"". Could you please provide more context or specify which meaning you are referring to?"
degrees Celsius	°C|摂氏度
km/h	km/h|キロメートル毎時
atmosphere	atm|アトモスフィア
cup	カップ|cup
kilograms	キログラム
light-years	光年|ライトイヤー
beats per minute	BPM|分あたりの拍数
kilometer	km|キロメートル
gravitation	Gravitation is a physical phenomenon and not a unit of measurement. Therefore, there are no symbols for it.
miles per gallon	mpg|マイル毎ガロン
psi	psi|ポンド毎平方インチ
bytes	bytes|バイト
days	日
years	年
liters	リットル | L
kilograms per cubic meter	kg/m³|キログラム毎立方メートル
on the Richter scale	リヒター・スケールによる
mph	マイル毎時
second squared	s^2|秒の二乗
volts	ボルト (volts in Japanese is the same as in English)
times per second	回毎秒|秒間あたり
Gs	"The symbol ""Gs"" can have different meanings depending on the context. Here are some possibilities:

- In physics, ""Gs"" can refer to the acceleration due to gravity, which is approximately 9.81 meters per second squared (m/s^2) or 32.2 feet per second squared (ft/s^2). In this case, the symbol is not usually written with a unit.
- In the context of centrifugation, ""Gs"" can refer to the relative centrifugal"
kelvins	ケルビン
centimeters	センチメートル | cm
light years	光年 | light years
megabytes	MB|メガバイト
nanometers	nm|ナノメートル
hours	時間
Richter scale	リヒター・スケール
decibels	dB|デシベル
billion miles	"10億マイル | NA (There is no commonly used symbol for ""billion"" in Japanese. The Japanese language uses the ""long scale"" system, where ""billion"" is equivalent to 10^9, and the word ""oku"" (億) is used instead.)"
minutes	分
cubic kilometers	立方キロメートル
quarts	クォート
metric tons	メートルトン
square miles	平方マイル|sq mi
Celsius	℃|摂氏
calories	cal|カロリー
square kilometers	km²|平方キロメートル
foldings	"I'm sorry, but I need more context to provide an accurate answer. ""Foldings"" could refer to a variety of things, and without more information, I cannot provide a list of possible symbols."
grams	グラム
galaxy	銀河|ギャラクシー
liters per minute	リットル毎分|L/min
sheets	"NA. ""Sheets"" is a unit of count and does not have a symbol."
acre	エーカー
widgets	"""Widgets"" is not a unit of measurement, so there are no symbols for it."
ounces	オンス (ounces)
keys	"Keys can refer to different things, so here are a few possible translations:

- Keys on a keyboard: キー
- Keys to a lock: 鍵 (かぎ, kagi)
- Keys to a car: カギ (kagi) or キー (kii)
- Keys to a house: 家の鍵 (いえのかぎ, ie no kagi)"
times stronger than Earth's	地球の何倍も強い | NA
kilogram	kg|キログラム
square feet	sq ft|平方フィート
minutes per mile	分毎マイル
miles per second	NA - Miles per second is not a commonly used unit in everyday life.
Pascals	パスカル (Pa)
PSI	PSI|ポンド毎平方インチ
tesla	Tesla|テスラ
pascals	パスカル
meters by meters	メートル x メートル
milligrams	ミリグラム | mg
kilograms meters per second	kg m/s|キログラムメートル毎秒
cylinders	NA (Cylinders is a unit of measurement for the number of cylinders in an engine, but it does not have a symbol)
meter	meters|m|メートル
mmHg	mmHg|ミリメートル水銀柱
kg	kg|キログラム
mAh	mAh|ミリアンペア時
minutes per kilometer	分毎キロメートル
hairs	"""hair"" is a countable noun, so it should be ""strands of hair"". 

strands of hair | 髪の毛の束"
battery	バッテリー
degrees	度
N	N|ニュートン
kilometers per hour	km/h|キロメートル毎時
milliliters	mL|ミリリットル
newtons	ニュートン
newton meter	N·m|ニュートンメートル
gram per milliliter	g/mL|グラム毎ミリリットル
meters per square second	m/s²|メートル毎秒二乗
Fahrenheit	華氏
seconds	秒
kilotons	キロトン
m/s²	m/s²|メートル毎秒の二乗
horsepower	hp|馬力
million miles	百万マイル|million miles
per minute	分あたり|分毎
Joules	ジュール
km	キロメートル|km
joules	J|ジュール
ml	ml|ミリリットル
grams per cubic centimeter	g/cm³|グラム毎立方センチメートル
heartbeat	NA (Heartbeat is a unit of measurement for the frequency of the heart's contractions, but it does not have a specific symbol.)
yards	ヤード|yd
pixels per inch	PPI|ピクセル毎インチ
calories per mile	カロリー毎マイル|calories per mile
units	I'm sorry, could you please provide more context or specify what you are looking for?
cubic feet per second	cubic feet per second|立方フィート毎秒
dB	dB|デシベル
weeks	週間|しゅうかん
nanoteslas	nT|ナノテスラ
people	人々|人類
day	日
hectopascals	hPa|ヘクトパスカル
second	秒
billion kilometers	10億キロメートル|1,000,000,000キロメートル
short tons	short tons|ショートトン
thousand feet	"NA - ""Thousand feet"" is not a standard unit of measurement. However, ""feet"" and ""thousand feet"" can be used to describe altitude in aviation."
billion years	10億年|Billion years
meter per second squared	m/s^2|メートル毎秒毎秒
nautical miles	海里 | ノーティカルマイル
cubic feet	立方フィート
megapixels	メガピクセル
revolutions per minute	RPM|分あたり回転数
pounds per gallon	ポンド毎ガロン|lbs/gal
gram per cubic centimeter	g/cm³|グラム毎立方センチメートル
cubic inches	立方インチ
times per day	"1. times per day: 回毎日 (kai maiban)
2. times per day: 日毎に回数 (hi goto ni kaisuu)
3. times per day: 日毎回数 (hi goto kaisuu)"
megajoules	MJ|メガジュール
carats	カラット
square meters	m²|平方メートル
atmospheres	気圧|atm
hertz	Hz|ヘルツ
tonnes	トン
British thermal units	BTU|英国熱量単位
mg	mg|ミリグラム
m/s	m/s|メートル毎秒
times	"There are different meanings for ""times"" depending on the context. Could you please provide more information or a specific context?"
mile	マイル
kilometers per second	km/s|キロメートル毎秒
million Kelvins	百万ケルビン | 1,000,000 K
breaths per minute	呼吸数/分|分あたりの呼吸数|分^-1の呼吸数
amperes	アンペア
Nm	Nm|ニュートンメートル
dBFS	dBFS|デシベルフルスケール
spectators	観客|かんきゃく
ft	フィート
g/cm³	g/cm³|グラム毎立方センチメートル
kelvin	ケルビン|K
millibars	mbar|ミリバール
Pascal	Pa|パスカル
millimeters	ミリメートル|mm
trillion miles	兆マイル|cho-mairu
bpm	bpm|分あたりの拍数
kWh	kWh|キロワット時
ly	ly|光年
