down in the dumps	in den Müllkippen|in den Mülltonnen|in den Abfallbehältern|in den Abfallgruben
keeping all balls in the air	alle Bälle in der Luft halten
knocks it out of the park	schlägt es aus dem Park|haut es aus dem Park|treibt es aus dem Park heraus
put all your eggs in one basket	alle Eier in einen Korb legen|alle Eier in einen Korb setzen|alle Eier in einen Korb tun
think outside the box	außerhalb der Box denken
calls a spade a spade	das Kind beim Namen nennen|die Dinge beim Namen nennen|einen Spaten einen Spaten nennen
dead tired	totmüde|todmüde|hundemüde|kaputt
fell apart	auseinandergefallen|zerfallen|auseinander gebrochen|kaputt gegangen|kaputt gemacht
pass with flying colors	mit fliegenden Fahnen bestehen
under the weather	unter dem Wetter|unter dem Einfluss des Wetters|krank|unwohl|angeschlagen|nicht ganz auf der Höhe|nicht ganz fit|nicht ganz gesund|nicht ganz bei Kräften|nicht ganz auf Zack|nicht ganz auf der Höhe sein|nicht ganz fit sein|nicht ganz gesund sein|nicht ganz bei Kräften sein|nicht ganz auf Zack sein
get a word in edgewise	ein Wort dazwischen bekommen|ein Wort dazwischen bringen|ein Wort dazwischen schieben
spills the beans	die Bohnen verschütten|die Bohnen ausplaudern|das Geheimnis verraten|auspacken
face the music	der Musik ins Auge sehen|sich der Musik stellen|der Musik gegenüberstehen|sich der Musik stellen müssen
over the moon	über dem Mond|über dem Mond sein|überglücklich sein|sehr glücklich sein|sehr erfreut sein|sehr zufrieden sein|sehr begeistert sein|sehr erfreut sein|sehr froh sein|sehr erfreut sein|sehr erfreut sein|sehr erfreut sein|sehr erfreut sein|sehr erfreut sein|sehr erfreut sein|se
to pull it off	es schaffen|es durchziehen|es hinbekommen|es bewerkstelligen|es vollbringen
keep their eyes on the ball	die Augen auf den Ball richten|den Blick auf den Ball richten|den Ball im Auge behalten
speaks with a forked tongue	mit gespaltener Zunge sprechen
bite the bullet	die Kugel beißen
on it like a crutch	drauf wie auf eine Krücke
take everything he says with a grain of salt	Nimm alles, was er sagt, mit einer Prise Salz|Nimm alles, was er sagt, mit Vorsicht|Nimm alles, was er sagt, mit Skepsis|Nimm alles, was er sagt, mit Zurückhaltung
out of left field	aus dem linken Feld|aus dem linken Feld heraus|aus dem linken Feld kommend
sink or swim	untergehen oder schwimmen
sour grapes	sauer Trauben
wait and see	abwarten und sehen
silver bullet	Silberne Kugel
cut the mustard	den Senf abschneiden|den Senf schneiden
a catch	ein Fang|ein Fangen|eine Falle|ein Fanggerät
beat around the bush	um den heißen Brei herumreden|um den Brei herumreden|um den Busch herumreden|sich im Kreis drehen|sich im Kreis bewegen|sich im Kreis drehen wie ein Hund, der sich in den Schwanz beißt
like a fish out of water	wie ein Fisch auf dem Trockenen|wie ein Fisch außerhalb des Wassers|wie ein Fisch ohne Wasser
burn the candle at both ends	Die Kerze an beiden Enden anzünden|Die Kerze von beiden Enden brennen lassen
chew the fat	das Fett kauen|das Fett zerkauen|das Fett durchkauen
bury the hatchet	das Kriegsbeil begraben
bark up the wrong tree	am falschen Baum bellen
pick myself up by my bootstraps	mich an meinen Stiefelriemen hochziehen| mich an meinen Stiefelschlaufen hochziehen
pie in the sky	Kuchen am Himmel|Kuchen in den Wolken|Kuchen in weiter Ferne|unrealistische Versprechungen
Pandora's box	Pandoras Büchse|Pandoras Kiste
to play it by ear	etwas aus dem Bauch heraus entscheiden|etwas spontan entscheiden|etwas improvisieren|etwas ohne Plan machen
through the wringer	durch die Mangel gedreht|durch den Wolf gedreht|durch die Presse gegangen|durch die Hölle gegangen
you have to break a few eggs to make an omelette	Man muss ein paar Eier brechen, um ein Omelett zu machen.
a big softie	ein großer Weicher|eine große Weiche|ein großer Softie|eine große Softie
drop the ball	den Ball fallen lassen|den Ball fallenlassen|den Ball fallen werfen|den Ball fallenwerfen
to play second fiddle	zweite Geige spielen
not my cup of tea	nicht mein Fall|nicht mein Ding|nicht mein Geschmack|nicht meine Tasse Tee
to bite the bullet	die Zähne zusammenbeißen|die Kugel beißen
the ball rolling	den Ball ins Rollen bringen|den Ball rollen lassen
a piece of cake	ein Stück Kuchen|ein Kuchenstück|ein Keks|ein Plätzchen|ein Leichtes|ein Kinderspiel|eine Kleinigkeit
his word	seine Worte
her cool	NA
plan A	Plan A
making a mountain out of a molehill	aus einer Mücke einen Elefanten machen|aus einer Mücke einen Berg machen|aus einer Mücke ein Drama machen|aus einer Kleinigkeit ein großes Problem machen
skeletons in his closet	Leichen im Keller haben
hit the nail on the head	den Nagel auf den Kopf treffen
bigger fish to fry	größere Fische zu braten haben
it takes two to tango	Dazu gehören immer zwei|Zum Tango gehören immer zwei|Zum Tanzen gehören immer zwei|Es braucht immer zwei zum Tango
hit the hay	ins Bett gehen|ins Heu schlagen|ins Heu gehen|ins Stroh schlagen|ins Stroh gehen
bats in his belfry	Fledermäuse in seinem Glockenturm haben|Fledermäuse in seinem Dachboden haben|Fledermäuse im Kopf haben|eine Meise haben|nicht alle Tassen im Schrank haben|nicht ganz dicht sein|nicht alle Latten am Zaun haben
hot under the collar	heiß unter dem Kragen|heiß unterm Kragen|erhitzt unter dem Kragen|erhitzt unterm Kragen
smoke and mirrors	Rauch und Spiegel
a chip on his shoulder	ein Chip auf seiner Schulter
the icing on the cake	das Tüpfelchen auf dem i|das Sahnehäubchen auf dem Kuchen|die Kirsche auf der Torte
a chip off the old block	ein Splitter vom alten Block|ein Stück vom alten Block|ein Abklatsch des alten Blocks|ein Abbild des alten Blocks
break a leg	brich dir ein Bein|breche dir ein Bein|breche dein Bein|breche dir dein Bein
tighten our belts	unsere Gürtel enger schnallen|unsere Gürtel straffer ziehen|unsere Gürtel fester schnüren
barking up the wrong tree	am falschen Ast sägen|am falschen Baum bellen|den falschen Ansatz verfolgen|auf dem falschen Dampfer sein|auf dem Holzweg sein
stick to her guns	an ihren Waffen festhalten|an ihren Prinzipien festhalten|an ihren Überzeugungen festhalten
his heart set on	sein Herz auf etwas gesetzt haben|sein Herz auf etwas gelegt haben|sein Herz auf etwas gerichtet haben
an uphill battle	ein Kampf bergauf
in over her head	über dem Kopf sein|überfordert sein|nicht mehr weiterwissen|nicht mehr klarkommen
with words	mit Worten
circumstances beyond our control	Umstände außerhalb unserer Kontrolle
her own business	ihr eigenes Geschäft|ihre eigene Firma|ihre eigene Unternehmung|ihre eigene Firma führen|ihre eigene Firma gründen
running around like a headless chicken	herumlaufen wie ein kopfloses Huhn|herumrennen wie ein kopfloses Huhn|wie ein kopfloses Huhn herumlaufen|wie ein kopfloses Huhn herumrennen
the show	die Show|die Vorstellung|die Aufführung
food for thought	Stoff zum Nachdenken|Nahrung für den Geist|Denkanstoß|Anregung zum Nachdenken
between you and me	zwischen dir und mir
take shape	Gestalt annehmen|Form annehmen|sich formen|sich gestalten
a litter of kittens	ein Wurf Kätzchen
roll with the punches	mit den Schlägen rollen|mit den Schlägen umgehen|sich den Schlägen anpassen|sich den Schlägen beugen
To let the cat out of the bag	Die Katze aus dem Sack lassen.
between a rock and a hard place	zwischen Hammer und Amboss|zwischen Baum und Borke|zwischen Scylla und Charybdis|zwischen zwei Übeln
knocking on wood	auf Holz klopfen
your chickens before they're hatched	Deine Hühner zählen, bevor sie geschlüpft sind|Deine Hühner zählen, bevor sie ausgebrütet sind|Deine Hühner zählen, bevor sie schlüpfen
nipped it in the bud	den Keim ersticken|den Keim im Keim ersticken|es im Keim ersticken|es im Keim ersticken
spilled milk	verschüttete Milch
ins and outs	Ins und Outs
pick up the ball and run with it	den Ball aufheben und damit losrennen|den Ball aufnehmen und damit loslaufen|den Ball aufnehmen und damit rennen
put your best foot forward	setze dein bestes Bein vor|setze deinen besten Fuß vor|setze deinen besten Fuß nach vorne|setze dein bestes Bein nach vorne
Burning bridges	Brücken verbrennen
beg, borrow or steal	betteln, leihen oder stehlen
let the chips fall where they may	Lass die Chips fallen, wo sie wollen|Lass die Karten fallen, wie sie wollen|Lass es geschehen, wie es geschehen muss|Lass es auf sich beruhen|NA
walking the talk	Reden und Handeln in Einklang bringen|Taten folgen lassen|Worte in die Tat umsetzen|Das Gesagte auch tun
break the ice	das Eis brechen
put our best foot forward	unseren besten Fuß vorwärts setzen|unseren besten Fuß nach vorne setzen|unser Bestes geben|unsere beste Leistung zeigen
play it by ear	es auf sich zukommen lassen|es improvisieren|es spontan entscheiden|es aus dem Bauch heraus machen
bee in his bonnet	Biene in seinem Hut|Biene in seinem Bonnet|Biene in seiner Mütze
separating the wheat from the chaff	die Spreu vom Weizen trennen
putting money aside for a rainy day	Geld für einen Regentag beiseitelegen|Geld für schlechte Zeiten sparen|Geld für Notfälle sparen|Geld für unvorhergesehene Ausgaben zurücklegen
call it a day	den Tag beenden|den Tag abschließen|den Tag abbrechen|den Tag für beendet erklären
on cloud nine	auf Wolke neun sein
spice things up	Würze die Dinge auf|Würze die Sache|Bringe Würze in die Sache|Bringe Würze in die Dinge
at home	zu Hause
seize the day	Nutze den Tag|Ergreife den Tag|Packe den Tag beim Schopf|Greife den Tag beim Schopf
nodding off	einnicken|wegnicken|einschlafen|nickend einschlafen|mit dem Kopf nicken und einschlafen
like a duck to water	wie ein Fisch im Wasser|wie eine Ente im Wasser
hit the books	in die Bücher eintauchen|in die Bücher vertiefen|sich in die Bücher stürzen|sich in die Bücher vertiefen|sich in die Bücher hineinknien
bounce back	zurückprallen|zurückfedern|zurückhüpfen|zurückkommen
building castles in the air	Luftschlösser bauen
fighting chance	Kampfchance|Kampfmöglichkeit|Kampfgelegenheit
my back	mein Rücken
coming up roses	alles läuft wie am Schnürchen|alles läuft wie geschmiert|alles läuft glatt|alles läuft reibungslos
golden touch	goldener Touch
hit the ground running	mit Vollgas starten|sofort durchstarten|gleich voll einsteigen|direkt loslegen
cut to the chase	zur Sache kommen|zum Wesentlichen kommen|zum Punkt kommen
stranger than fiction	seltsamer als die Fiktion
keep an eye on them	behalte sie im Auge|halte sie im Auge|beobachte sie|achte auf sie
digs in her heels	in ihren Fersen graben|in ihre Fersen graben|in den Boden stampfen|sich weigern, sich zu bewegen|sich weigern, nachzugeben
let out a sigh of relief	einen Seufzer der Erleichterung ausstoßen|einen Seufzer der Erleichterung von sich geben
down the drain	den Bach runter|hinunter in den Abfluss|hinunter in den Ausguss|verloren|verschwendet|umsonst
cost an arm and a leg	ein Vermögen kosten|einen Arm und ein Bein kosten|einen Arm und ein Bein verlangen|sehr teuer sein
bend over backwards	sich nach hinten beugen|sich rückwärts beugen|sich übermäßig anstrengen|sich über Gebühr anstrengen|sich übermäßig bemühen|sich über Gebühr bemühen
sit well with me	gut bei mir ankommen|mir gut gefallen|mir zusagen|mir passen
In a nutshell	in einer Nussschale
green around the gills	grün um die Kiemen|grün um die Kiemenschieber|grün im Gesicht|übel aussehen|übel riechen
chip on his shoulder	ein Chip auf seiner Schulter|ein Stück Holz auf seiner Schulter|ein Stückchen Holz auf seiner Schulter|ein Stückchen Holz auf seiner Schulter haben|ein Chip auf seiner Schulter haben
keep your chin up	Halte dein Kinn hoch|Halte dein Kinn oben|Halte den Kopf hoch|Halte den Kopf oben
dropped the ball	den Ball fallen gelassen|den Ball fallenlassen|den Ball fallen gelassen haben|den Ball fallenlassen haben
put all his eggs in one basket	alle seine Eier in einen Korb tun|alle seine Eier in einen Korb setzen|alle seine Eier in einen Korb legen
see eye to eye	übereinstimmen|gleicher Meinung sein|auf einer Wellenlänge sein|übereinkommen
right up my alley	genau mein Ding|genau meine Kragenweite|genau mein Fachgebiet|genau mein Metier
beating a dead horse	ein totes Pferd schlagen|ein totes Pferd reiten
have a cow	eine Kuh haben
threw in the towel	das Handtuch geworfen|das Handtuch geschmissen|aufgegeben|sich geschlagen geben
lean on her	sich auf sie lehnen|sich an sie lehnen|sich auf sie stützen|sich an sie stützen
hammer out	herausarbeiten|herauszimmern|herausklopfen|herausmeißeln
to go the extra mile	die extra Meile gehen
stolen her thunder	ihr den Donner gestohlen|ihren Donner gestohlen|ihren Donner weggenommen|ihren Donner gestohlen haben
caught between a rock and a hard place	zwischen Hammer und Amboss sein|zwischen Baum und Borke sein|zwischen zwei Stühlen sitzen|in der Zwickmühle sein
fallen flat	flach fallen|scheitern|nicht funktionieren|nicht klappen|nicht aufgehen
to bite off more than I can chew	mehr abbeißen, als ich kauen kann
up in the air	in der Luft|in der Höhe|oben in der Luft|oben in der Höhe
up in smoke	in Rauch aufgehen|in Rauch aufgelöst werden|verpuffen|verdampfen
dead in the water	tot im Wasser|tot im Meer|leblos im Wasser|leblos im Meer
sink in	einsinken|versinken|sinken
to hit the hay	ins Bett gehen|ins Heu schlagen|ins Heu gehen|ins Stroh schlagen|ins Stroh gehen
running around like a chicken with its head cut off	herumlaufen wie ein Huhn ohne Kopf|herumrennen wie ein Huhn ohne Kopf|wie ein Huhn ohne Kopf herumlaufen|wie ein Huhn ohne Kopf herumrennen
behind the eight ball	in einer schwierigen Lage sein|in einer misslichen Lage sein|in einer ungünstigen Lage sein|in einer schlechten Position sein
in a rut	in einer Sackgasse|in einer Krise|in einer Flaute|in einer Routine
to butter me up	mich einschmeicheln|mich schmeicheln|mir Honig ums Maul schmieren|mir Honig um den Mund schmieren|mir Honig ums Kinn schmieren|mir Honig um den Bart schmieren|mir Honig um die Ohren schmieren|mir Honig um die Nase schmieren|mir Honig um den Finger wickeln|mir Honig um den Daumen wickeln|mir Hon
the ground running	der Boden läuft|der Lauf des Bodens
the whole nine yards	die ganze neun Yards
a clean slate	eine saubere Tafel|eine leere Tafel|eine unbeschriebene Tafel|ein unbeschriebenes Blatt Papier|ein weißes Blatt Papier|ein weißes Blatt
put the cart before the horse	den Karren vor das Pferd spannen|das Pferd hinter den Karren spannen|den Wagen vor das Pferd setzen|den Wagen vor das Pferd spannen
the box	die Box|der Kasten|der Karton
bite off more than I can chew	mehr abbeißen als ich kauen kann
her pride	ihr Stolz
in no time	in kürzester Zeit|im Handumdrehen|blitzschnell|schnell wie der Blitz|in null Komma nichts|in Windeseile|im Nu|innerhalb von Sekunden|in Rekordzeit
keep our eyes peeled	Augen offen halten|Augen aufhalten|Augen aufsperren|Augen aufreißen
to wrap his head around	seinen Kopf um etwas wickeln|seinen Kopf um etwas herumwickeln|seinen Kopf um etwas herumkriegen|sich den Kopf um etwas herumwickeln|sich den Kopf um etwas herumkriegen
early bird catches the worm	Der frühe Vogel fängt den Wurm.
put their nose to the grindstone	die Nase an den Schleifstein legen|die Nase an den Schleifstein setzen|die Nase an den Schleifstein drücken
to cut to the chase	zur Sache kommen|zum Punkt kommen|direkt zur Sache kommen|direkt zum Punkt kommen
whole new ballgame	ganz neues Spiel|ganz neue Situation|ganz neue Herausforderung
to pull your leg	jemanden auf den Arm nehmen|jemanden veräppeln|jemanden veralbern|jemanden zum Narren halten
to keep their chin up	den Kopf hochhalten|das Kinn hochhalten|die Stimmung hochhalten|sich nicht unterkriegen lassen
take the backseat	auf den Rücksitz gehen|auf den Hintersitz gehen|auf den hinteren Sitzplatz gehen
strike while the iron is hot	Das Eisen schmieden, solange es heiß ist.
breathe easy	leicht durchatmen|leicht atmen|leichter atmen|leichtes Atmen
a spoonful of sugar	ein Löffel Zucker
in the red	im roten Bereich|im Minus|im Defizit|im Schuldenstand
feel under the weather	sich schlapp fühlen|sich unwohl fühlen|sich kränklich fühlen|sich nicht wohl fühlen|sich nicht gut fühlen
hits the nail on the head	den Nagel auf den Kopf treffen
of leeway	Spielraum|Spielräume|Spielräumen
in due course	zu gegebener Zeit|im Laufe der Zeit|mit der Zeit|früher oder später
spill the beans	die Bohnen verschütten|die Bohnen auskippen|die Bohnen ausplaudern|das Geheimnis verraten
Bite the bullet	die Zähne zusammenbeißen|auf die Zähne beißen|den Schmerz ertragen|sich zusammenreißen|sich durchbeißen
keep their eyes peeled	die Augen offen halten|die Augen gespitzt halten|die Augen aufhalten|die Augen aufsperren
put our noses to the grindstone	unsere Nasen an den Schleifstein legen|unsere Nasen an den Schleifstein setzen|unsere Nasen an die Arbeit setzen|unsere Nasen zur Mühle legen|unsere Nasen zur Mühle setzen|unsere Nasen zur Arbeit setzen
turn the tables	die Tische umdrehen|die Tische umkehren|die Tische wenden
fall through	durchfallen|durchrasseln|nicht bestehen|scheitern|fehlschlagen
keep the ball rolling	den Ball am Rollen halten|den Ball in Bewegung halten|den Ball weiterrollen lassen
let the cat out of the bag	die Katze aus dem Sack lassen
hang in there	halt durch|bleib dran|halte durch|bleibe dran
a blur	eine Unschärfe|ein verschwommenes Bild|ein verschwommenes Objekt|ein verschwommenes Etwas
pull the wool over people's eyes	jemandem Wolle vor die Augen ziehen|jemanden täuschen|jemanden hinters Licht führen|jemanden in die Irre führen
dropping the ball	den Ball fallen lassen|den Ball fallenlassen|den Ball fallenwerfen|den Ball fallenwerfen lassen
pull himself together	sich zusammenreißen|sich zusammennehmen|sich zusammenfassen|sich sammeln|sich konzentrieren
rat race	Rattenrennen
to hit the ground running	"""Hit the ground running"" means to start a new activity with a lot of energy and enthusiasm. A literal translation could be ""mit voller Energie und Begeisterung starten""."
spot on	genau richtig|punktgenau|auf den Punkt|exakt|präzise
stringing her along	sie hinhalten|sie vertrösten|sie vertrödeln|sie auf die lange Bank schieben
a cash cow	eine Goldgrube|eine Gelddruckmaschine|eine Cashcow
traffic jam	Verkehrsstau|Verkehrsstockung|Stau|Verkehrsknotenpunkt|Verkehrshindernis|Verkehrshemmung
went the whole nine yards	alle neun Yards gegangen
let sleeping dogs lie	schlafende Hunde soll man nicht wecken
dot our i's and cross our t's	unsere i's punkten und unsere t's kreuzen
paint the town red	die Stadt rot anmalen|die Stadt rot streichen|die Stadt rot färben
pulled myself up by my bootstraps	habe mich an meinen Stiefelriemen hochgezogen|habe mich an meinen Stiefelschlaufen hochgezogen
bail out	aussteigen|aussteigen lassen|aussteigen aus|aussteigen auslassen|aussteigen aussteigen|aussteigen aussteigen lassen|aussteigen aussteigen aus|aussteigen aussteigen auslassen|aussteigen lassen|aussteigen lassen lassen|aussteigen lassen aus|aussteigen lassen auslassen|aussteigen lassen aussteigen|aussteigen lassen aussteigen lassen|aussteigen lassen aussteigen
point him in the right direction	Zeige ihm in die richtige Richtung|Weise ihn in die richtige Richtung|Zeige ihm den richtigen Weg|Weise ihn zum richtigen Weg
to keep a stiff upper lip	eine steife Oberlippe bewahren|eine steife Oberlippe behalten|eine feste Oberlippe bewahren|eine feste Oberlippe behalten
sleep on it	darüber schlafen
fish out of water	Fisch auf dem Trockenen|Fisch an Land|Fisch außerhalb seines natürlichen Elements|Fisch außerhalb seines Gewässers
a laugh riot	ein Lachriot|eine Lachorgie|eine Lachsalve|ein Lachanfall
make or break	machen oder brechen
let off steam	Dampf ablassen|Luft ablassen|sich abreagieren|sich auspowern
click with you	mit jemandem auf einer Wellenlänge sein|mit jemandem harmonieren|mit jemandem klarkommen|mit jemandem gut auskommen
slow as molasses	langsam wie Melasse
flat as a pancake	flach wie ein Pfannkuchen
calls the shots	die Schüsse abgeben|die Entscheidungen treffen|das Sagen haben|den Ton angeben
talk the hind legs off a donkey	jemandem die Ohren abkauen|jemandem die Ohren vollquatschen|jemandem die Ohren abquatschen|jemandem die Ohren abreden
fly off the handle	aus der Haut fahren|ausflippen|die Fassung verlieren|sich aufregen|sich auf die Palme bringen|sich auf den Schlips getreten fühlen
throw in the towel	das Handtuch werfen|das Handtuch schmeißen|aufgeben|kapitulieren
bite your tongue	beiß dir auf die Zunge|beiße dir auf die Zunge|halt dir die Zunge|halte dir die Zunge
to get a foot in the door	einen Fuß in die Tür bekommen|einen Fuß in der Tür haben|einen Fuß in der Tür stehen haben
let their hair down	die Haare herunterlassen|die Haare runterlassen|sich entspannen|sich locker machen|sich gehen lassen
have a chip on her shoulder	einen Chip auf der Schulter haben
to keep their heads above water	den Kopf über Wasser halten
beating around the bush	um den heißen Brei herumreden|um den Brei herumreden|um den Busch herumreden|um den heißen Busch herumreden
to keep my chin up	den Kopf hochhalten|das Kinn hochhalten|aufrecht bleiben|nicht den Mut verlieren|nicht aufgeben
started to butt heads	begannen, mit den Köpfen zusammenzustoßen
to move the goalposts	das Ziel verschieben|die Torpfosten verschieben
let bygones be bygones	das Vergangene ruhen lassen|das Vergangene hinter sich lassen|das Vergangene vergessen|das Vergangene ruhen lassen
keep all her ducks in a row	alle Enten in einer Reihe behalten|alle Enten in einer Reihe haben|alle Enten in einer Reihe halten
laugh his head off	sich den Kopf ab(lachen)|sich kaputtlachen|sich totlachen
jump out of her skin	aus der Haut fahren|aus ihrer Haut fahren|aus der Haut springen|aus ihrer Haut springen
at a snail's pace	im Schneckentempo|mit Schneckengeschwindigkeit|sehr langsam|extrem langsam
come out of his shell	aus seiner Schale kommen|aus seiner Hülle kommen|aus seinem Panzer kommen
get one's act together	seine Sachen zusammenbekommen|seine Angelegenheiten in Ordnung bringen|seine Handlungen koordinieren|seine Handlungen organisieren
as cool as a cucumber	so cool wie eine Gurke
a wild-goose chase	eine Schnitzeljagd|eine wilde Gänsejagd|eine sinnlose Suche|eine vergebliche Suche|eine aussichtslose Suche
keep the wolf from the door	den Wolf von der Tür fernhalten
she has ants in her pants	sie hat Ameisen in der Hose
putting all their eggs in one basket	alle ihre Eier in einen Korb tun|alle ihre Eier in einen Korb setzen|alle ihre Eier in einen Korb legen
get a foot in the door	einen Fuß in die Tür bekommen|einen Fuß in der Tür haben|einen Fuß in der Tür stehen haben
burn the midnight oil	das Mitternachtsöl verbrennen|das Öl der Mitternacht verbrennen|bis spät in die Nacht arbeiten|bis spät in die Nacht lernen
feather in her cap	Feder in ihrem Hut|Feder in ihrem Kappe
turn over a new leaf	ein neues Blatt umdrehen|ein neues Blatt wenden|eine neue Seite aufschlagen|sich bessern|sich ändern|sich verbessern
have his cake and eat it too	seinen Kuchen haben und ihn auch essen|seinen Kuchen behalten und ihn auch essen|seinen Kuchen besitzen und ihn auch essen
weight off her shoulders	Gewicht von ihren Schultern|Last von ihren Schultern
better than a poke in the eye with a sharp stick	besser als ein Stich ins Auge mit einem scharfen Stock|besser als ein Stich ins Auge mit einem spitzen Stock|besser als ein Stich ins Auge mit einem scharfen Stift|besser als ein Stich ins Auge mit einem spitzen Stift
ballpark figure	ungefähre Zahl|ungefährer Wert|ungefährer Betrag|ungefährer Preis|ungefährer Richtwert
all your eggs in one basket	alle Eier in einen Korb tun|alle Eier in einen Korb setzen|alle Eier in einen Korb legen
actions speak louder than words	Taten sprechen lauter als Worte.
with a pinch of salt	mit einer Prise Salz
tied to the apron strings	an den Schürzenbändern gebunden sein|an den Schürzenfäden gebunden sein
off the top of his head	aus dem Stegreif|ohne nachzudenken|ohne Vorbereitung|ohne Überlegung
knock on wood	auf Holz klopfen
music to my ears	Musik in meinen Ohren|Musik in meinen Ohren sein
in hot water	in heißem Wasser|in heißem Dampf|in Schwierigkeiten|in der Klemme|in Bedrängnis|in Not
couch potato	Couchkartoffel
went their separate ways	gingen getrennte Wege
to look on the bright side	die Dinge positiv sehen|die Dinge von der positiven Seite betrachten|die Dinge von der hellen Seite betrachten
to keep my head above water	über Wasser halten|den Kopf über Wasser halten|sich über Wasser halten
her bridges	"I'm sorry, but ""her bridges"" is not a complete phrase or sentence. Please provide more context or information."
burning a hole in my pocket	ein Loch in meine Tasche brennen
set in his ways	in seinen Wegen gefangen|in seinen Gewohnheiten gefangen|in seinen Ansichten gefangen|in seinen Überzeugungen gefangen
to play fast and loose	mit etwas spielen|schnell und locker spielen|schnell und leichtsinnig spielen|schnell und unzuverlässig spielen
to throw in the towel	das Handtuch werfen|das Handtuch schmeißen|aufgeben|kapitulieren
cold shoulder	kalte Schulter
big fish in a small pond	großer Fisch in einem kleinen Teich
burning the midnight oil	das Mitternachtsöl verbrennen|das Öl der Mitternacht verbrennen|die Mitternachtsstunde mit Arbeit verbringen|bis spät in die Nacht arbeiten
damp squib	feuchtes Feuerwerk|nasses Feuerwerk|feuchter Knaller|nasser Knaller|enttäuschendes Ereignis|enttäuschender Vorfall
keep my chin up	den Kopf hochhalten|das Kinn hochhalten
take the rap	die Schuld auf sich nehmen|die Verantwortung übernehmen|den schwarzen Peter haben
getting the hang of it	den Dreh rausbekommen|den Bogen rausbekommen|den Bogen raushaben|den Dreh raushaben
in over my head	über meinem Kopf|überfordert|überfordert sein|überfordert sein mit etwas|in etwas verwickelt sein, das man nicht bewältigen kann
cool head	kühler Kopf
life of the party	Lebensmittelpunkt der Party|Lebensmittelpunkt der Feier|Lebensmittelpunkt des Festes
noses to the grindstone	Nasen an den Schleifstein|Nasen am Schleifstein|Nasen auf den Schleifstein drücken
bigger picture	größeres Bild
get on the same page	auf die gleiche Seite kommen|auf einer Seite sein|auf einer Wellenlänge sein|auf gleicher Ebene sein
off the cuff	aus dem Stegreif|ohne Vorbereitung|unvorbereitet|spontan
her all	NA
to sweeten the pot	den Topf süßen|den Topf versüßen|den Einsatz erhöhen|das Angebot verbessern|das Angebot attraktiver machen
bought hook, line and sinker	etwas mit Haut und Haaren schlucken|etwas ohne zu hinterfragen glauben|etwas bedingungslos akzeptieren|etwas blindlings glauben
to go the distance	die Strecke bis zum Ende gehen|die Strecke bis zum Schluss gehen|bis zum Ende durchhalten|bis zum Schluss durchhalten
to treat yourself	sich selbst verwöhnen|sich selbst belohnen|sich selbst gönnen|sich selbst behandeln
spinning our wheels	unsere Räder drehen|unsere Räder im Leerlauf drehen|unsere Räder durchdrehen|unsere Räder ohne Fortschritt drehen
silver lining	Silberstreif am Horizont
to hit the nail on the head	den Nagel auf den Kopf treffen
with a chip on her shoulder	mit einem Chip auf ihrer Schulter
with a grain of salt	mit einer Prise Salz|mit einem Körnchen Salz|mit Salz|mit Vorsicht|mit Skepsis|mit Zurückhaltung
to play devil's advocate	den Advokaten des Teufels spielen
a social butterfly	ein geselliger Schmetterling
the benefit of the doubt	der Vorteil des Zweifels
a bitter pill to swallow	eine bittere Pille zum Schlucken
a fish out of water	ein Fisch außerhalb des Wassers|ein Fisch an Land
sell it like hotcakes	es wie warme Semmeln verkaufen
pull out all the stops	alle Register ziehen|alle Hebel in Bewegung setzen|keine Kosten und Mühen scheuen|sich ins Zeug legen|sich voll reinhängen
all hat, no cattle	viel Lärm um nichts|viel Wind um nichts|alles Gerede, keine Taten|alles Gerede, keine Substanz
to pass up	verpassen|vorbeigehen lassen|nicht wahrnehmen|nicht ergreifen|nicht nutzen
to stay ahead of the game	der Konkurrenz einen Schritt voraus bleiben|dem Spiel voraus bleiben|vor dem Spiel bleiben|vor dem Spiel einen Schritt voraus bleiben
to turn over a new leaf	ein neues Blatt umdrehen|ein neues Blatt wenden|eine neue Seite aufschlagen|sich bessern|sich ändern|sich verbessern
drop in the bucket	ein Tropfen auf den heißen Stein|ein Tropfen im Ozean|ein Tropfen auf den heißen Stein im Ozean
sticker shock	Preisschock|Schock durch den Preis|Schock beim Anblick des Preises
take a rain check	einen Regencheck nehmen
has her ducks in a row	hat ihre Enten in einer Reihe|hat ihre Enten in einer Reihe aufgereiht|hat ihre Enten in einer Reihe geordnet
jump on the bandwagon	auf den fahrenden Zug aufspringen|auf den Zug aufspringen|mit auf den Zug aufspringen|mit auf den fahrenden Zug aufspringen
cross the finish line	die Ziellinie überqueren|die Ziellinie durchlaufen|die Ziellinie passieren
butterflies in his stomach	Schmetterlinge im Bauch haben
lick my wounds	meine Wunden lecken
kill two birds with one stone	zwei Fliegen mit einer Klappe schlagen
red herrings	rote Heringe
of the essence	von wesentlicher Bedeutung|von entscheidender Bedeutung|essentiell|wesentlich|unabdingbar|unerlässlich
she missed the boat	sie hat das Boot verpasst
the bush	der Busch
a fly in the ointment	eine Fliege in der Salbe|eine Fliege im Salz|eine Fliege im Öl|ein Störfaktor|ein Hindernis|ein Problem
you're tilting at windmills	Du kämpfst gegen Windmühlen|Du kämpfst gegen Windmühlenflügel|Du kämpfst gegen Windräder|Du kämpfst gegen Windgespinste
keep an eye on him	halte ein Auge auf ihn|behalte ihn im Auge|achte auf ihn|beobachte ihn
moving the goalposts	das Ziel verschieben|die Zielstangen verschieben|die Tore verschieben
playing both sides	auf beiden Seiten spielen|beide Seiten bedienen|auf zwei Hochzeiten tanzen
robbing Peter to pay Paul	Petrus berauben, um Paulus zu bezahlen|Petrus bestehlen, um Paulus zu bezahlen|Petrus ausrauben, um Paulus zu bezahlen|Petrus bestehlen, um Paulus zu bezahlen
cold feet	kalte Füße
up the creek without a paddle	ohne Paddel den Fluss hinauf|ohne Paddel auf dem Fluss|ohne Paddel auf dem Fluss treiben|ohne Paddel auf dem Fluss sein|ohne Paddel auf dem Fluss sitzen|ohne Paddel auf dem Fluss stecken
silver spoon in her mouth	Silberlöffel im Mund haben|mit einem Silberlöffel im Mund geboren sein|in Wohlstand geboren sein
hitting the hay	ins Heu schlagen|ins Heu hauen|ins Bett gehen|sich schlafen legen|sich zur Ruhe begeben
the real McCoy	der echte McCoy
stirring the pot	den Topf umrühren|den Topf bewegen|den Topf schütteln|den Topf rühren
take the bull by the horns	den Stier bei den Hörnern packen|den Bullen bei den Hörnern packen|den Stier bei den Hörnern nehmen|den Bullen bei den Hörnern nehmen
live it up	es ausleben|es genießen|es voll auskosten|es in vollen Zügen genießen
back in the saddle	zurück im Sattel
jump ship	das Schiff verlassen|vom Schiff springen|das Schiff springen lassen
play my cards right	meine Karten richtig spielen
pushing the envelope	das Umschlag schieben|das Kuvert schieben|das Briefumschlag schieben|das Briefkuvert schieben
get off her high horse	vom hohen Ross herunterkommen|vom hohen Ross absteigen|vom hohen Ross steigen
cut corners	Ecken abschneiden|Abkürzungen nehmen|Abkürzungen machen|Abkürzungen einschlagen|Ecken abkürzen
put your nose to the grindstone	die Nase am Schleifstein haben|die Nase am Schleifstein schleifen|die Nase am Schleifstein reiben
flies off the handle	aus der Haut fahren|ausflippen|die Beherrschung verlieren|sich aufregen|sich auf die Palme bringen|sich auf den Schlips getreten fühlen
go back to square one	zurück zum Anfang gehen|zurück zum Start gehen|zurück zum Ursprung gehen|zurück zum Nullpunkt gehen
hit rock bottom	auf dem Tiefpunkt angekommen sein|den Tiefpunkt erreicht haben|den absoluten Tiefpunkt erreicht haben|am absoluten Tiefpunkt angekommen sein
point me in the right direction	Zeige mir die richtige Richtung|Zeige mir in die richtige Richtung|Zeige mir den richtigen Weg|Zeige mir in die richtige Richtung, in die ich gehen soll
the name of the game	der Name des Spiels
rocket science	Raketenwissenschaft
hold my horses	halte meine Pferde|halte meine Pferdchen|warte einen Moment|warte kurz|warte mal
in the dark	im Dunkeln
go the extra mile	die Extrameile gehen
kick the bucket	den Löffel abgeben|das Zeitliche segnen|sterben|ins Gras beißen|den Abgang machen|das Zeitliche segnen|das Zeitliche segnen|das Zeitliche segnen|das Zeitliche segnen|das Zeitliche segnen|das Zeitliche segnen|das Zeitliche segnen|das Zeitliche segnen|das Zeitliche segnen|das Zeitliche segnen|das Zeitliche segnen|das Zeitliche segnen|das
burn that bridge when we come to it	Verbrenne diese Brücke, wenn wir zu ihr kommen.
brick wall	Ziegelwand
chicken out	sich vor etwas drücken|sich vor etwas drücken wie ein Huhn|sich wie ein Huhn drücken|sich wie ein Huhn verhalten
have butterflies in his stomach	Schmetterlinge im Bauch haben
a chip on my shoulder	ein Chip auf meiner Schulter
laugh their head off	sich den Kopf ab(lachen)|sich kaputtlachen|sich totlachen|sich halbtotlachen
all hands on deck	alle Hände an Deck
under wraps	unter Verschluss|unter Verschluß|unter Verschwiegenheit|geheim|vertraulich|nicht öffentlich|nicht bekanntgegeben|nicht publik gemacht|nicht veröffentlicht
to beat around the bush	um den heißen Brei herumreden|um den Brei herumreden|um den heißen Brei herumtanzen|um den Brei herumtanzen|sich im Kreis drehen|sich im Kreis bewegen|sich im Kreis winden|sich im Kreis drehen wie ein Fähnchen im Wind
wet behind the ears	noch grün hinter den Ohren|noch unerfahren|noch nicht ausgereift|noch nicht reif
in order	in Ordnung|in der Reihenfolge|nacheinander|hintereinander|aufeinanderfolgend
nip it in the bud	im Keim ersticken|im Ansatz ersticken|im Frühstadium unterbinden|im Anfangsstadium unterbinden
took the plunge	den Sprung wagen|sich trauen etwas zu tun|etwas riskieren|etwas wagen
bring home the bacon	das Geld nach Hause bringen|den Lebensunterhalt verdienen|die Brötchen verdienen|das Brot verdienen
big break	große Pause|große Unterbrechung|große Chance|große Gelegenheit|großer Durchbruch
out of the blue	aus heiterem Himmel
blank out	ausblenden|auslöschen|leer machen|leer werden|leer sein|leer bleiben|leer bleiben|leer bleiben|leer bleiben|leer bleiben|leer bleiben|leer bleiben|leer bleiben|leer bleiben|leer bleiben|leer bleiben|leer bleiben|leer bleiben|leer bleiben|leer bleiben|leer bleiben|leer bleiben|leer bleiben|leer bleiben|leer bleiben
feeling under the weather	sich kränklich fühlen|sich unwohl fühlen|sich schlapp fühlen|sich nicht wohl fühlen|sich angegriffen fühlen|sich matt fühlen|sich schwach fühlen|sich nicht gut fühlen
sit on her hands	auf den Händen sitzen
went out the window	ging aus dem Fenster|hinaus aus dem Fenster gegangen|aus dem Fenster verschwunden|aus dem Fenster gegangen
feeling jittery	nervös sein|zittrig sein|unruhig sein|aufgeregt sein
by the wayside	am Straßenrand|am Wegesrand|an der Straßenseite|an der Wegseite
get away from it all	weg von allem kommen|weg von allem wegkommen|von allem wegkommen|von allem weggehen
cash cow	Geldkuh|Gelddruckmaschine|Goldesel|Einnahmequelle
off the charts	von der Skala ab|von der Skala weg|von der Skala entfernt|außerhalb der Skala
to heart	zum Herzen
flash in the pan	Strohfeuer|kurzes Aufflackern|kurzes Aufblitzen|kurzes Aufleuchten
dogged determination	hartnäckige Entschlossenheit|verbissene Entschlossenheit|unbeirrbare Entschlossenheit
meeting of the minds	Treffen der Köpfe|Zusammentreffen der Geister|Zusammentreffen der Meinungen|Treffen der Meinungen
burn any bridges	alle Brücken abbrechen|alle Brücken verbrennen|alle Brücken hinter sich abbrechen|alle Brücken hinter sich verbrennen
bite my tongue	auf meine Zunge beißen|auf die Zunge beißen
to break the ice	das Eis brechen
to clean house	das Haus putzen|das Haus reinigen|das Haus aufräumen
to call it a day	den Tag beenden|den Tag abschließen|den Tag abbrechen|den Tag für beendet erklären
walking on eggshells	auf Eierschalen gehen|auf Eierschalen laufen|auf Eierschalen treten
fair weather	schönes Wetter|gutes Wetter|sonniges Wetter
to get our foot in the door	unseren Fuß in die Tür bekommen|unseren Fuß in der Tür haben|unseren Fuß in der Tür haben wollen
count her chickens before they hatched	die Hühner zählen, bevor sie geschlüpft sind|die Hühner zählen, bevor sie ausgebrütet sind|vorzeitig jubeln|vorzeitig feiern
Burning the midnight oil	das Mitternachtsöl verbrennen|das Öl der Mitternacht verbrennen|bis spät in die Nacht arbeiten|bis spät in die Nacht lernen
keep your head above water	den Kopf über Wasser halten
put two and two together	zwei und zwei zusammenzählen|zwei und zwei addieren|zwei und zwei verbinden|zwei und zwei kombinieren
black and white	schwarz und weiß
missed the boat	das Boot verpasst haben|den Zug verpasst haben|die Gelegenheit verpasst haben|zu spät kommen
fast learner	schneller Lerner|schnelle Lernerin|schneller Lernender|schnelle Lernende
let it all hang out	lass alles raus|häng alles raus|zeig alles|zeig alles, was du hast
walk the walk	den Weg gehen|das Gerede in die Tat umsetzen|Taten sprechen lassen|seinen Worten Taten folgen lassen
your foot in the door	dein Fuß in der Tür
get our ducks in a row	unsere Enten in eine Reihe bringen|unsere Enten in einer Reihe aufstellen|unsere Enten in Ordnung bringen|unsere Enten in Reih und Glied bringen
to have her cake and eat it too	Ihren Kuchen haben und ihn auch essen|verzehren wollen
have bigger fish to fry	wichtigere Fische zu braten haben
let my hair down	mein Haar herunterlassen|mein Haar locker machen|mein Haar auslassen|mein Haar frei lassen
has a heart of gold	hat ein Herz aus Gold
put my two cents in	meinen Senf dazugeben|meinen Beitrag leisten|meine Meinung sagen|meinen Standpunkt äußern
the pedal to the metal	das Pedal auf das Metall drücken|das Pedal aufs Metall drücken|das Pedal bis zum Anschlag durchtreten|das Pedal durchdrücken
spilling the beans	die Bohnen verschütten|die Bohnen auskippen|das Geheimnis ausplaudern|ausplaudern, was man nicht sagen sollte
outside the box	außerhalb der Box|außerhalb des Kastens|jenseits der Box|jenseits des Kastens
a thorn in my side	ein Dorn in meiner Seite
making waves	Wellen schlagen|mächtig Eindruck machen|für Aufsehen sorgen|für Wirbel sorgen
lame duck	lahme Ente
all mouth and no trousers	viel Lärm um nichts|mehr Schein als Sein|große Klappe, nichts dahinter|viel heiße Luft, nichts dahinter
practice makes perfect	Übung macht den Meister
brownie points	Brauniepunkte
a can of worms	eine Dose Würmer
deer caught in headlights	Reh im Scheinwerferlicht gefangen|Reh im Scheinwerferlicht erwischt|Reh im Scheinwerferlicht starren
more harm than good	mehr Schaden als Nutzen
the bag	die Tasche
a stiff upper lip	eine steife obere Lippe
blew her top	ihren Deckel weggeblasen|ihren Deckel verloren|ihren Deckel abgesprengt|ihren Deckel hochgehen lassen|ihren Deckel verpuffen lassen|ihren Deckel explodieren lassen|ihren Deckel platzen lassen|ihren Deckel durchbrennen lassen|ihren Deckel durchdrehen lassen|ihren Deckel verlieren|ihren Deckel abnehmen|ihren
to tighten our belts	unsere Gürtel enger schnallen|unsere Gürtel straffer ziehen|unsere Gürtel fester schnüren
to stay above water	über Wasser bleiben|über Wasser bleiben (fig.)|nicht untergehen|nicht untergehen (fig.)
finger-licking good	zum Fingerlecken gut|zum Ablecken der Finger gut|zum Fingerabschlecken gut
to face the music	der Musik ins Auge sehen|sich der Musik stellen|sich der Konsequenz stellen|die Suppe auslöffeln
to fit a square peg into a round hole	einen quadratischen Stift in ein rundes Loch stecken|einen quadratischen Stift in ein rundes Loch passen|einen quadratischen Stift in ein rundes Loch zwängen|einen quadratischen Stift in ein rundes Loch pressen
be a breath of fresh air	eine frische Brise sein|eine Erfrischung sein|frischen Wind bringen|frischen Wind hereinbringen
get back on the horse	wieder aufs Pferd steigen|wieder auf den Gaul steigen|wieder aufs Ross steigen|wieder aufs Pferd setzen|wieder auf den Gaul setzen|wieder aufs Ross setzen
to be ahead of the curve	eine Nasenlänge voraus sein|einen Schritt voraus sein|einen Vorsprung haben|vor der Kurve sein
to bark up the wrong tree	am falschen Baum bellen
made the cut	die Hürde geschafft|die Voraussetzungen erfüllt|die Anforderungen erfüllt|die Auswahl bestanden
to bring home the bacon	den Speck nach Hause bringen
To make a long story short	um es kurz zu machen|um es kurz zu fassen|um es kurz zu sagen|um es kurz zu halten
lean on	sich anlehnen|sich stützen auf|sich verlassen auf|sich berufen auf
rock the boat	das Boot zum Schaukeln bringen|das Boot wackeln lassen|Unruhe stiften|für Aufregung sorgen
shoulder to cry on	Schulter zum Ausweinen|Schulter zum Weinen|Schulter zum Ausheulen|Schulter zum Heulen
kill them with kindness	töte sie mit Freundlichkeit|töte sie durch Freundlichkeit|töte sie mittels Freundlichkeit|töte sie durch Nettigkeit|töte sie mit Nettigkeit|töte sie mittels Nettigkeit
at a low ebb	in einem Tiefpunkt|in einer schwierigen Phase|in einer schlechten Verfassung|in einer niedrigen Ebbe
on the ball	auf dem Ball|auf dem Ball sein|am Ball sein|bei der Sache sein|konzentriert sein|auf Zack sein|fit sein|auf Draht sein|wachsam sein|alert sein
pull it off	es schaffen|es durchziehen|es hinbekommen|es bewerkstelligen|es vollbringen
perseverance pays off	Durchhaltevermögen zahlt sich aus.
land on his feet	auf seinen Füßen landen|auf seinen Beinen landen|aufrecht landen|stehen bleiben beim Landen
take your eye off the ball	den Blick vom Ball abwenden|den Blick vom Ball nehmen|den Ball aus den Augen verlieren
cutting the mustard	Senf schneiden|Senf abschneiden|Senf zerkleinern|Senf hacken
feel the burn	das Brennen spüren|das Brennen fühlen|den Schmerz spüren|den Schmerz fühlen
grin from ear to ear	von einem Ohr zum anderen grinsen
cup of tea	Tasse Tee
pat on the back	Klopfen auf den Rücken|Klopfen auf den Rücken als Zeichen der Anerkennung|Schulterklopfen|Anerkennung durch Klopfen auf den Rücken
peaches and cream	Pfirsiche und Sahne
on edge	auf Kante|auf der Kante|auf dem Rand|am Rande|an der Kante|an der Grenze|an der Schwelle|in Spannung|angespannt|nervös|unruhig|aufgeregt|in Erwartung|in Erwartung von etwas|in Erwartung von etwas sein|in Erwartung von etwas gespannt sein|in Erwartung von etwas aufgeregt sein|in Erwartung von
pinch of salt	Prise Salz
close to his chest	nah an seiner Brust|nah an seinem Herzen|in seiner Brust verschlossen|in seinem Herzen verschlossen
cutting it too thin	es zu dünn schneiden|es zu knapp schneiden|es zu eng kalkulieren|es zu knapp kalkulieren|es zu riskant machen|es zu riskant kalkulieren
midnight oil	Mitternachtsöl
guts and grit	Mut und Entschlossenheit
moving full steam ahead	mit voller Dampfkraft vorwärts bewegen|mit voller Dampfkraft vorwärts gehen|mit voller Dampfkraft vorwärts fahren
play both sides	auf beiden Seiten spielen|beide Seiten spielen|auf beiden Seiten mitspielen|beide Seiten bedienen
stay put	bleib an Ort und Stelle|bleib wo du bist|bleib sitzen|bleib stehen
Biting the bullet	die Kugel beißen
you can't have your cake and eat it too	Man kann nicht alles haben|Man kann nicht alles haben und behalten|Man kann nicht alles haben und auch noch genießen|Man kann nicht alles haben und es auch noch essen
pulling my leg	mir ein Bein stellen|an meinem Bein ziehen|an meinem Bein zupfen|an meinem Bein rütteln
pulled the rug out from under me	hat mir den Boden unter den Füßen weggezogen|hat mir den Teppich unter den Füßen weggezogen|hat mir den Boden unter den Füßen weggezogen
Barking up the wrong tree	auf dem falschen Baum bellen
budge an inch	einen Zoll nachgeben|einen Zoll weichen|einen Zoll bewegen|einen Zoll rücken
running on fumes	auf dem letzten Loch pfeifen|auf dem Zahnfleisch gehen|auf dem letzten Dampf laufen|auf dem letzten Tropfen Benzin fahren
off the wall	von der Wand weg|von der Wand entfernt|von der Wand ab
raining on our parade	uns den Tag verderben|uns den Spaß verderben|uns die Laune verderben|uns den Umzug verregnen
playing with fire	mit dem Feuer spielen
hunker down	sich zusammenkauern|sich zusammenrollen|sich zusammenkrümmen|sich zusammenpressen
cross that bridge when I come to it	die Brücke überqueren, wenn ich dazu komme|die Brücke überqueren, wenn ich dort bin|die Brücke überqueren, wenn ich soweit bin|die Brücke überqueren, wenn ich ankomme
the good fight	der gute Kampf
take the plunge	den Sprung wagen|den Schritt wagen|sich trauen|sich etwas zutrauen|etwas riskieren|etwas wagen
the blues	der Blues
turn things around	Dinge umdrehen|Dinge umkehren|Dinge umschwenken|Dinge umstellen|Dinge ändern|Dinge verbessern
be there for her	für sie da sein
sweep them under the rug	sie unter den Teppich kehren|sie unter den Tisch kehren|sie verstecken|sie vertuschen
cooking the books	die Bücher frisieren|die Bücher manipulieren|die Bücher fälschen|die Bücher schönen
broke the ice	das Eis brechen
the real deal	das echte Geschäft|der echte Deal|die echte Sache|das wirkliche Geschäft|der wirkliche Deal|die wirkliche Sache
take a load off	eine Last abnehmen|eine Last ablegen|eine Last von sich nehmen|sich ausruhen|sich entspannen
a bunch of baloney	ein Haufen Unsinn|ein Haufen Quatsch|ein Haufen Blödsinn|ein Haufen Schmarrn
thin ice	dünnes Eis
batting an eye	mit den Augen blinzeln|mit den Augen zwinkern|mit den Augenlidern zucken
chickens out	sich vor etwas drücken|sich vor etwas drücken wie ein Huhn|sich wie ein Huhn vor etwas drücken|sich wie ein Huhn verhalten
burn bridges	Brücken abbrechen|Brücken verbrennen|Brücken zerstören|Brücken hinter sich abbrechen|Brücken hinter sich verbrennen|Brücken hinter sich zerstören
keep our ducks in a row	unsere Enten in einer Reihe behalten|unsere Enten in einer Reihe halten|unsere Enten hintereinander aufstellen|unsere Enten ordentlich aufreihen
behind closed doors	hinter verschlossenen Türen|in verschlossenen Räumen|unter Ausschluss der Öffentlichkeit|im Geheimen
pull the wool over my eyes	mir Wolle über die Augen ziehen
throwing money down the drain	Geld down the drain werfen|Geld zum Fenster rauswerfen|Geld verschwenden|Geld verprassen|Geld verpulvern
come back to bite him	ihm zurückbeißen|ihm auf die Füße fallen|sich gegen ihn wenden|sich rächen
apple pie	Apfelkuchen
cabin fever	Hüttenfieber
put all our eggs in one basket	alle unsere Eier in einen Korb tun|alle unsere Eier in einen Korb setzen|alle unsere Eier in einen Korb legen
have a bee in his bonnet	eine Laus im Pelz haben|eine Laus im Kopf haben|eine fixe Idee haben|eine fixe Idee im Kopf haben|eine fixe Idee im Schädel haben|eine fixe Idee im Hirn haben|eine fixe Idee im Gehirn haben
add up	zusammenzählen|addieren|aufsummieren
chasing her tail	ihrem Schwanz nachjagen|ihrem Schwanz hinterherjagen|ihrem eigenen Schwanz hinterherlaufen|sich im Kreis drehen
beat a dead horse	auf einem toten Pferd reiten|ein totes Pferd schlagen|ein totes Pferd reiten|ein totes Pferd schlagen
count your chickens before they hatch	Die Hühner zählen, bevor sie schlüpfen|Die Hühner zählen, bevor sie ausgebrütet sind|Die Hühner zählen, bevor sie geschlüpft sind
to kill two birds with one stone	zwei Fliegen mit einer Klappe schlagen
keep his eye on the ball	das Auge auf den Ball richten|das Auge auf den Ball halten|den Blick auf den Ball richten|den Blick auf den Ball halten
cloud nine	Wolke neun
wrong tree	falscher Baum
read between the lines	zwischen den Zeilen lesen
monkey business	Affengeschäft|Affentheater|Unsinn|Unfug|Schabernack|Klamauk
sting in the tail	Stachel im Schwanz|Stachel im Schweif
landing on his feet	auf seinen Füßen landen
bee in her bonnet	Biene im Hut haben|Biene im Kopf haben|eine fixe Idee haben|eine fixe Idee im Kopf haben
not the end of the world	nicht das Ende der Welt
social butterfly	geselliger Schmetterling
not his cup of tea	nicht sein Fall|nicht seine Tasse Tee|nicht sein Ding|nicht seine Welt
march to the beat of your own drum	dem eigenen Rhythmus folgen|dem eigenen Takt folgen|nach dem eigenen Takt marschieren|nach dem eigenen Rhythmus marschieren
get her feet wet	ihre Füße nass machen|ihre Füße ins Wasser stecken|ihre Füße benetzen
stop and smell the roses	anhalten und die Rosen riechen|stehen bleiben und die Rosen riechen|anhalten und den Duft der Rosen genießen|stehen bleiben und den Duft der Rosen genießen
step up their game	ihr Spiel verbessern|ihre Leistung steigern|sich anstrengen, um besser zu werden|sich anstrengen, um ihr Spiel zu verbessern
take it easy	Nimm es leicht|Nimm es einfach|Nimm es ruhig|Nimm es locker|Entspann dich|Beruhige dich
showed his true colors	seine wahren Farben gezeigt|seine wahren Absichten gezeigt|seine wahren Gefühle gezeigt
bunch of hogwash	Haufen von Unsinn|Haufen von Quatsch|Haufen von Mist|Haufen von Schmarrn|Haufen von Blödsinn
beauty contest	Schönheitswettbewerb
the bee's knees	die Knie der Biene
keep her head above water	den Kopf über Wasser halten|den Kopf über Wasser behalten
death warmed over	Tod aufgewärmt
a big fish in a small pond	ein großer Fisch in einem kleinen Teich
can stomach	verdauen können|vertragen können|den Magen vertragen können
sweating bullets	Schwitzen wie ein Schwein|Schwitzen wie ein Wasserfall|Schwitzen wie ein Pferd|Schwitzen wie ein Ochse|Schwitzen wie ein Bär|Schwitzen wie ein Esel|Schwitzen wie ein Hund|Schwitzen wie ein Affe|Schwitzen wie ein Iltis|Schwitzen wie ein Fuchs|Schwitzen wie ein Stier|Schwitzen wie ein Truthahn|Schwit
a bee in her bonnet	eine Biene in ihrem Hut|eine Biene in ihrer Mütze|eine Biene in ihrem Bonnet
in over his head	über dem Kopf|über dem Kopf hinweg|überfordert|überfordert sein|überfordert sein mit der Situation|sich in einer Situation befinden, die zu schwierig ist|sich in einer Situation befinden, die man nicht bewältigen kann
lend a hand	eine Hand leihen|eine Hand borgen|eine Hand ausleihen|eine Hand geben
in the bag	im Sack|in der Tasche|sicher|gewiss|garantiert
has bees in his bonnet	Bienen im Kopf haben
miss the boat	das Boot verpassen|den Zug verpassen|die Gelegenheit verpassen|zu spät kommen
had bats in her belfry	hatte Fledermäuse im Glockenturm
rest on his laurels	sich auf seinen Lorbeeren ausruhen
put all her eggs in one basket	alle ihre Eier in einen Korb tun|alle ihre Eier in einen Korb setzen|alle ihre Eier in einen Korb legen
chip off the old block	ein Abklatsch des Vaters|ein Abklatsch des Alten|ein Abklatsch des Altvaters|ein Abklatsch des Großvaters|ein Abklatsch des Alten Herrn
buried her head in the sand	hat ihren Kopf in den Sand gesteckt|hat ihren Kopf in den Sand vergraben|hat ihren Kopf in den Sand gesteckt und ignoriert, was passiert ist
touch base	in Kontakt treten|sich melden|sich kurz absprechen|kurz kommunizieren
there's no tomorrow	Es gibt kein Morgen|Es gibt keinen Morgen|Kein Morgen ist in Sicht|Kein Morgen wird kommen
at loggerheads	sich in den Haaren liegen|sich in den Wolle haben|sich in den Haaren haben|sich in den Wolle liegen|in Streit liegen|in Konflikt liegen|in Unstimmigkeit liegen|in Zwietracht liegen|in Uneinigkeit liegen|in Disharmonie liegen|in Auseinandersetzung liegen|in Streitigkeit liegen|in Meinungsverschied
the elephant in the room	der Elefant im Raum
put their best foot forward	ihren besten Fuß vorwärts setzen|ihren besten Fuß nach vorne setzen|ihren besten Fuß zeigen
keep his cool	ruhig bleiben|die Ruhe bewahren|cool bleiben|gelassen bleiben
put her foot in her mouth	sich ins eigene Fleisch schneiden|sich ins eigene Bein schießen|sich ins eigene Knie schießen|sich ins eigene Maul treten|sich ins eigene Kinn treten|sich ins eigene Gesicht schlagen|sich ins eigene Auge stechen|sich ins eigene Ohr beißen|sich ins eigene Haar beißen|sich ins eigene Knie bei
hold your horses	halte deine Pferde|halte deine Hengste|halte deine Rosse|halte deine Gauls|warte einen Moment|warte mal|nicht so schnell|nicht voreilig sein
stealing the show	die Show stehlen
wears his heart on his sleeve	sein Herz auf der Zunge tragen|sein Herz auf dem Ärmel tragen
to mind her own beeswax	sich um ihre eigene Angelegenheiten kümmern|sich um ihr eigenes Bienenwachs kümmern|sich um ihre eigenen Bienen kümmern
cracked the whip	die Peitsche knallen lassen|mit der Peitsche knallen|mit der Peitsche knallen gemacht haben|mit der Peitsche geknallt haben
to keep her head above water	den Kopf über Wasser halten
skeletons in the closet	Leichen im Keller
the skin of his teeth	mit knapper Not|mit Ach und Krach|gerade noch so|mit letzter Kraft|mit letzter Anstrengung
not to take things personally	Dinge nicht persönlich nehmen
Biting off more than you can chew	Sich mehr vornehmen, als man bewältigen kann|Sich übernehmen|Sich zu viel zumuten|Sich zu viel aufbürden
put his two cents in	seinen Senf dazugeben|seinen Kommentar abgeben|seine Meinung sagen|seine Gedanken äußern
keep an eye out	ein Auge offen halten|Ausschau halten|aufpassen|wachsam sein
shooting for the moon	auf den Mond schießen|auf den Mond zielen|nach dem Mond greifen
changes horses midstream	Ein Pferd mitten im Fluss wechseln|Ein Pferd während des Flusses wechseln|Während des Flusses das Pferd wechseln|Das Pferd während des Flusses wechseln
thrown for a loop	aus der Bahn geworfen|aus dem Konzept gebracht|verwirrt|überrascht
jump through hoops	durch Reifen springen|durch Hoops springen|durch Hürden springen
letting her hair down	die Haare herunterlassen
lose sleep over something	über etwas den Schlaf verlieren
get his ducks in a row	seine Enten in eine Reihe bringen|seine Enten in einer Reihe haben|seine Enten in Reih und Glied bringen|seine Enten in Reih und Glied haben
hit it out of the park	treffe es aus dem Park|hau es aus dem Park|schlag es aus dem Park|treffe es aus dem Stadion|hau es aus dem Stadion|schlag es aus dem Stadion
manage her time better	ihre Zeit besser managen|besser mit ihrer Zeit umgehen
fishy going on	etwas Fischiges geht vor|etwas Seltsames geht vor|etwas Merkwürdiges geht vor|etwas Verdächtiges geht vor
reap what he sows	ernten, was er sät
going around in circles	im Kreis gehen|im Kreis laufen|sich im Kreis drehen|kreisförmig gehen|kreisförmig laufen|kreisförmig drehen
stick with it	dabei bleiben|daran festhalten|dabei bleiben, dranbleiben|daran bleiben, dranbleiben
on top of the world	auf der Spitze der Welt|auf dem Gipfel der Welt|auf dem Höhepunkt der Welt|auf dem Zenit der Welt
let his hair down	sich gehen lassen|sich entspannen|sich locker machen|sich ausgelassen verhalten
keep your eye on the ball	halte dein Auge auf dem Ball|halte deine Augen auf dem Ball|halte den Blick auf dem Ball|halte deinen Blick auf dem Ball
fair shake	gerechter Schütteln|gerechte Schüttelung|gerechter Shake|gerechter Schlag
steals the show	die Show stehlen
get them straightened out	Sie gerade rücken|Sie in Ordnung bringen|Sie ausrichten|Sie ausbügeln
the best thing since sliced bread	das Beste seit geschnittenem Brot
burning the candle at both ends	Die Kerze an beiden Enden anzünden|Die Kerze von beiden Enden brennen lassen
carved out a successful career	eine erfolgreiche Karriere herausgearbeitet|eine erfolgreiche Karriere geschnitzt|eine erfolgreiche Karriere gemeißelt
the ball	der Ball
made it big	es groß gemacht haben|es weit gebracht haben|es zu etwas gebracht haben|es geschafft haben
dance to your own tune	Tanze nach deiner eigenen Melodie.
to keep your eye on the ball	das Auge auf den Ball richten|das Auge auf den Ball halten|den Ball im Auge behalten
let her hair down	die Haare herunterlassen|die Haare runterlassen|sich entspannen|locker werden|sich gehen lassen
keeping her in the dark	Sie im Dunkeln lassen|Sie im Unklaren lassen|Sie im Ungewissen lassen
in a pickle	in der Klemme|in der Patsche|in Schwierigkeiten|in Not|in Bedrängnis|in Verlegenheit|in einer misslichen Lage
throwing in the towel	das Handtuch werfen|das Handtuch schmeißen|aufgeben|kapitulieren
on the wrong side of the bed	auf der falschen Seite des Bettes aufstehen
the brass ring	der Messingring
test the waters	das Wasser testen|die Gewässer testen
six of one and half a dozen of the other	sechs von einem und eine halbe Dutzend von dem anderen|sechs von einem und ein halbes Dutzend von dem anderen|sechs von einem und sechs von dem anderen
seeing red	rot sehen
blow their socks off	ihnen die Socken wegblasen|ihnen die Socken ausziehen|sie umhauen|sie beeindrucken
to let off steam	Dampf ablassen|Luft ablassen|sich abreagieren|sich auspowern
a shot in the dark	ein Schuss ins Dunkle|ein Schuss ins Blaue|ein Schuss ins Ungewisse
the green light	das grüne Licht
hot water	heißes Wasser
to see stars	Sterne sehen
woke up on the wrong side of the bed	mit dem falschen Fuß aufgestanden sein
rain check	Regen-Check|Regen-Überprüfung|Regen-Kontrolle|Regen-Prüfung
blow his own trumpet	seine eigene Trompete blasen|seine eigene Posaune blasen
shaken like a leaf	zittern wie ein Blatt|zittern wie ein Espenblatt|zittern wie ein Pappelblatt
a tough cookie	ein harter Keks|ein taffer Keks|ein zäher Keks
black ice	schwarzes Eis
in her element	in ihrem Element sein
on pins and needles	auf Nadeln und Stecknadeln|auf Nadeln und Nähnadeln|auf Nadeln und Nadeln|auf Nadeln und Stiften
a rock and a hard place	zwischen Hammer und Amboss|zwischen zwei Übeln|zwischen Scylla und Charybdis
old hat	alte Hut
hit the road	Mach dich auf den Weg|Geh auf die Straße|Fahr los|Starte die Reise
a few tricks up their sleeve	ein paar Tricks in petto haben|ein paar Tricks auf Lager haben|ein paar Tricks im Ärmel haben
to rock the boat	das Boot zum Schaukeln bringen|das Boot ins Wanken bringen|für Unruhe sorgen|für Aufregung sorgen|für Ärger sorgen
to hit the sack	ins Bett gehen|in die Federn gehen|in die Kiste gehen|in die Heia gehen|in die Koje gehen|in die Pofe gehen|in die Falle gehen|in die Horizontale gehen|sich schlafen legen|sich zur Ruhe begeben
to follow one's heart	seinem Herzen folgen|dem Herzen folgen
to get the ball rolling	den Ball ins Rollen bringen|den Ball zum Rollen bringen|den Anstoß geben|den Startschuss geben
to turn the corner	die Ecke umdrehen|die Kurve kriegen|die Wende schaffen|die Wende erreichen
to see the light at the end of the tunnel	das Licht am Ende des Tunnels sehen
fishing in troubled waters	in trüben Gewässern fischen
to take the bull by the horns	den Stier bei den Hörnern packen|den Stier bei den Hörnern nehmen
out of this world	außerhalb dieser Welt|nicht von dieser Welt|überirdisch|unwirklich|unglaublich
cracked a smile	ein Lächeln aufsetzen|ein Lächeln zeigen|ein Lächeln auflegen|ein Lächeln aufsetzen
on the same page	auf der gleichen Seite|auf derselben Seite|auf einer Seite sein
let you off the hook	dich vom Haken lassen|dich freilassen|dich entlasten|dich entlassen
silly goose	alberne Gans|dumme Gans|verrückte Gans
turning the tables	die Tische umdrehen|die Rollen tauschen|die Situation umkehren|die Verhältnisse umkehren
cross that bridge when we come to it	die Brücke überqueren, wenn wir dazu kommen|die Brücke überqueren, wenn wir dort sind|die Brücke überqueren, wenn wir soweit sind|die Brücke überqueren, wenn wir ankommen
hit it off	sich gut verstehen|sich auf Anhieb gut verstehen|sich auf Anhieb sympathisch sein|sich auf Anhieb mögen
blow off some steam	Dampf ablassen|sich abreagieren|sich auspowern|sich entspannen
living in a dream world	in einer Traumwelt leben
green behind the ears	NA
all thumbs	zwei linke Hände haben|ungeschickt sein|tollpatschig sein
bag of rags	Sack voller Lumpen|Tasche voller Fetzen
loose ends	lose Enden|offene Enden|unbeendete Dinge|unfertige Dinge|unvollständige Dinge
around the block	um den Block|um den Häuserblock|um den Straßenblock|um den Viertelblock
more than I can chew	mehr als ich kauen kann|mehr als ich beißen kann|mehr als ich schlucken kann
paying off	abbezahlen|tilgen|auszahlen|begleichen
blew my mind	hat meinen Verstand gesprengt|hat meinen Verstand geblasen
see eye-to-eye	Augen-zu-Augen sehen
big cheese	großer Käse
a tempest in a teapot	ein Sturm im Wasserglas
make time	Zeit machen|Zeit schaffen|Zeit freimachen
count our chickens before they hatch	die Hühner zählen, bevor sie schlüpfen|die Hühner zählen, bevor sie ausgebrütet sind|vorzeitig Erfolg feiern|vorzeitig jubeln
water under the bridge	Wasser unter der Brücke|Vergangenheit|abgehakt|vorbei
throws a curveball	einen Curveball werfen
just what the doctor ordered	genau das, was der Arzt verschrieben hat|genau das, was der Arzt verordnet hat
too little too late	zu wenig zu spät
put all my eggs in one basket	alle meine Eier in einen Korb tun|alle meine Eier in einen Korb setzen|alle meine Eier in einen Korb legen
rubbing salt in my wounds	Salz in meine Wunden reiben
fly by the seat of his pants	nach Gefühl fliegen|nach Bauchgefühl fliegen|nach Instinkt fliegen|ohne Plan fliegen|ohne Vorbereitung fliegen
get lost	verlaufe dich|verirre dich|geh verloren|verschwinde|geh weg|zieh Leine|hau ab|verpiss dich|verschwinde
knowledge is power	Wissen ist Macht
meet halfway	sich auf halbem Weg treffen|sich in der Mitte treffen|sich auf halber Strecke treffen
keeping their eye on the ball	Das Auge auf den Ball gerichtet halten|Das Auge auf den Ball fokussieren|Den Blick auf den Ball richten|Den Ball im Auge behalten
paid through the nose	durch die Nase bezahlt|durch die Nase gezahlt|einen hohen Preis bezahlt|einen hohen Preis gezahlt
kick back and relax	zurücklehnen und entspannen|sich zurücklehnen und entspannen|sich zurücklehnen und relaxen|entspannen und relaxen
keep their noses to the grindstone	die Nase am Schleifstein halten|die Nase am Schleifstein schleifen|die Nase am Schleifstein reiben|die Nase am Schleifstein arbeiten
get your ducks in a row	Bringe deine Enten in eine Reihe|Bringe deine Enten in Ordnung|Bringe deine Enten in eine Linie|Bringe deine Enten in Reih und Glied
be at each other's throats	sich gegenseitig an die Gurgel gehen|sich gegenseitig an die Kehle gehen|sich gegenseitig an den Hals gehen
stand their ground	ihren Boden halten|ihren Standpunkt verteidigen|ihrem Standpunkt treu bleiben|ihrem Standpunkt standhalten
couldn't see the forest for the trees	den Wald vor lauter Bäumen nicht sehen können
Time flies	Die Zeit fliegt|Die Zeit vergeht wie im Flug|Die Zeit rast dahin
burst a blood vessel	platze ein Blutgefäß|platze ein Blutgefäss
get down to brass tacks	zur Sache kommen|zum Wesentlichen kommen|zum Punkt kommen|zur Kernfrage kommen
the wrong side of the bed	auf der falschen Seite des Bettes aufstehen
picks up the tab	die Rechnung übernehmen|die Zeche bezahlen|für etwas aufkommen|für etwas bezahlen
knocked it out of the park	es aus dem Park geschlagen|es aus dem Stadion geschlagen|es aus dem Feld geschlagen
keep his head above water	seinen Kopf über Wasser halten|seinen Kopf über Wasser behalten|den Kopf über Wasser halten|den Kopf über Wasser behalten
has a chip on her shoulder	einen Chip auf der Schulter haben
knows the ropes	die Seile kennen|die Stricke kennen|die Abläufe kennen|die Prozeduren kennen
set in their ways	in ihren Wegen festgefahren|in ihren Wegen verankert|in ihren Wegen verfestigt|in ihren Wegen verhärtet
bit my tongue	Ich habe mir auf die Zunge gebissen.
find his feet	seine Füße finden
in one ear and out the other	ins eine Ohr rein und ins andere Ohr raus|ins eine Ohr rein und durchs andere Ohr wieder raus|ins eine Ohr rein und sofort wieder raus aus dem anderen Ohr
back to square one	zurück zum Anfang|zurück zum Start|zurück auf Los|wieder von vorne anfangen
come true	wahr werden|in Erfüllung gehen|sich erfüllen|sich bewahrheiten
beats around the bush	um den heißen Brei herumreden|um den Brei herumreden|um den heißen Brei herumtanzen|um den Brei herumtanzen
a flash in the pan	ein Strohfeuer sein|eine Eintagsfliege sein|ein kurzes Aufblitzen sein
hit the hay early	Früh ins Bett gehen|Früh schlafen gehen|Früh zu Bett gehen|Frühzeitig ins Bett gehen|Frühzeitig schlafen gehen|Frühzeitig zu Bett gehen
lost her marbles	ihre Murmeln verloren|ihre Kugeln verloren|den Verstand verloren|verrückt geworden|verrückt geworden sein
wild card	Wilde Karte|Joker-Karte|Joker|NA
a little birdie told me	Ein Vögelchen hat mir gesagt.
getting our ducks in a row	unsere Enten in eine Reihe bringen|unsere Enten in einer Reihe aufstellen|unsere Enten in Ordnung bringen|unsere Enten in Reih und Glied bringen
to count his chickens before they hatch	seine Hühner zählen, bevor sie schlüpfen|seine Hühner zählen, bevor sie ausgebrütet sind|vorzeitig seine Hühner zählen
to grin and bear it	es mit einem Grinsen ertragen|es mit einem Lächeln ertragen|es ertragen und dabei grinsen|es ertragen und dabei lächeln
control freak	Kontrollfreak|Kontrollwütiger|Kontrollbesessener
took a rain check	einen Regencheck nehmen
live wire	lebendiger Draht|lebender Draht|aktiver Draht|aktive Leitung
chill out	entspann dich|chillen|relaxen|sich beruhigen|ruhig bleiben
off her chest	von der Brust weg|von der Brust herunter|von der Brust abnehmen|von der Brust nehmen
down for the count	ausgezählt|niedergeschlagen|am Boden liegen|am Boden bleiben
light at the end of the tunnel	Licht am Ende des Tunnels
to open a can of worms	eine Büchse der Pandora öffnen|eine Dose Würmer öffnen|eine heikle Angelegenheit aufmachen|ein heikles Thema ansprechen
make hay while the sun shines	Mach das Heu, solange die Sonne scheint.
find a needle in a haystack	eine Nadel im Heuhaufen finden
not even a crumb	nicht einmal eine Krümel|nicht mal eine Krümel|kein Krümel|kein Brösel
hit the sack	ins Bett gehen|ins Bett hüpfen|ins Bett springen|ins Bett fallen|ins Bett kriechen
butterflies in your stomach	Schmetterlinge im Bauch haben
to put on a brave face	eine tapfere Miene aufsetzen|eine tapfere Fassade aufbauen|eine mutige Haltung zeigen|sich tapfer zeigen
to pull out all the stops	alle Register ziehen|alle Hebel in Bewegung setzen|keine Kosten und Mühen scheuen|sich ins Zeug legen|sich voll reinhängen
a dish that steals the show	ein Gericht, das die Show stiehlt
fail by a country mile	um Meilen scheitern|um Längen scheitern|um einiges scheitern|weit daneben liegen|NA
to shoot your shot	sein Glück versuchen|seine Chance nutzen|seinen Schuss abgeben|sein Schuss wagen
to keep his head above water	den Kopf über Wasser halten
to prove them all wrong	allen das Gegenteil beweisen|allen das Falsche beweisen|allen widerlegen|allen Unrecht geben
tie the knot	den Knoten binden|den Knoten knüpfen
take it with a grain of salt	mit einer Prise Salz nehmen|mit einem Körnchen Salz nehmen|mit Vorsicht genießen|mit Skepsis betrachten|mit Zurückhaltung betrachten
pull someone's leg	jemandem auf den Arm nehmen|jemanden veräppeln|jemanden veralbern|jemanden verarschen
skip a beat	einen Schlag aussetzen|einen Herzschlag aussetzen|einen Augenblick innehalten|einen Moment zögern
to put my best foot forward	meinen besten Fuß vorwärts setzen|meinen besten Fuß voran setzen|meinen besten Fuß nach vorne setzen|meinen besten Fuß vorzeigen
keep his nose to the grindstone	seine Nase am Schleifstein halten|seine Nase an den Schleifstein halten|seine Nase am Schleiferstein halten|seine Nase an den Schleiferstein halten
get back on her feet	wieder auf die Beine kommen|wieder aufstehen|sich wieder erholen|sich wieder aufrappeln
