down in the dumps	deprimiert|niedergeschlagen|traurig|bedrückt|frustriert
keeping all balls in the air	alle Bälle in der Luft halten|alle Aufgaben im Blick haben|alles unter Kontrolle haben|alles im Griff haben
knocks it out of the park	eine großartige Leistung erbringen|einen Volltreffer landen|einen grandiosen Erfolg haben|eine hervorragende Leistung erzielen
put all your eggs in one basket	alles auf eine Karte setzen|alles auf ein Pferd setzen|alles riskieren, indem man nur eine Möglichkeit verfolgt
think outside the box	kreativ denken|unorthodox denken|neue Wege gehen|über den Tellerrand schauen
calls a spade a spade	etwas beim Namen nennen|klare Worte sprechen|direkt sagen, was man denkt|kein Blatt vor den Mund nehmen
dead tired	hundemüde|todmüde|völlig erschöpft|fix und fertig|am Ende sein
fell apart	zusammenbrechen|den Halt verlieren|sich auflösen|zerbrechen|sich nicht mehr im Griff haben
pass with flying colors	mit Bravour bestehen|mit Auszeichnung bestehen|sehr erfolgreich abschneiden|eine hervorragende Leistung erbringen
under the weather	sich schlapp fühlen|sich unwohl fühlen|krank sein|nicht auf der Höhe sein|angeschlagen sein
get a word in edgewise	zu Wort kommen|zu Wort kommen dürfen|zu Wort kommen können|etwas sagen können|etwas einwerfen können
spills the beans	ausplaudern|verraten|ein Geheimnis ausplaudern|ein Geheimnis verraten
face the music	die Konsequenzen tragen|müssen für seine Fehler geradestehen|für seine Fehler einstehen müssen|mit den Konsequenzen leben müssen
over the moon	überglücklich|begeistert|aus dem Häuschen sein|vor Freude ausflippen
to pull it off	etwas schaffen|etwas erreichen|etwas erfolgreich abschließen|etwas bewältigen
keep their eyes on the ball	sich auf das Wesentliche konzentrieren|sich auf das Ziel fokussieren|sich auf das Wichtigste konzentrieren
speaks with a forked tongue	lügt|redet mit gespaltener Zunge|sagt nicht die Wahrheit|ist unehrlich|ist doppelzüngig
bite the bullet	sich zusammenreißen|sich überwinden|etwas Unangenehmes tun müssen|den sauren Apfel beißen müssen
on it like a crutch	"on it like a crutch means relying heavily on something or someone. 

figurative translation: sich stark auf etwas/jemanden verlassen"
take everything he says with a grain of salt	seine Aussagen mit Vorsicht genießen|seine Aussagen kritisch betrachten|seine Aussagen hinterfragen|seine Aussagen nicht für bare Münze nehmen
out of left field	unerwartet|überraschend|unvorhersehbar|aus heiterem Himmel|aus dem Nichts
sink or swim	entweder man schafft es oder man scheitert|alles oder nichts|entweder man schwimmt oder man geht unter|entweder man besteht oder man fällt durch
sour grapes	schlechter Verlierer sein|nur aus Neid handeln|nur aus Missgunst handeln|nur aus Frust handeln
wait and see	abwarten und sehen|abwarten, wie es sich entwickelt|sich überraschen lassen|sich gedulden und schauen, was passiert
silver bullet	Lösung|Wundermittel|Allheilmittel|Patentlösung
cut the mustard	to perform satisfactorily|to meet expectations|to do a good job|to succeed
a catch	eine tolle Partie|ein toller Fang|ein Gewinn|ein Glücksfall
beat around the bush	um den heißen Brei herumreden|nicht direkt auf den Punkt kommen|sich nicht klar ausdrücken
like a fish out of water	sich unwohl fühlen|sich fremd fühlen|sich nicht zurechtfinden|sich nicht eingewöhnt haben
burn the candle at both ends	sich überarbeiten|sich verausgaben|sich zu viel zumuten|sich überfordern
chew the fat	sich unterhalten|plaudern|sich austauschen|sich über Belanglosigkeiten unterhalten
bury the hatchet	sich versöhnen|den Streit beilegen|den Konflikt begraben|sich aussöhnen|Frieden schließen
bark up the wrong tree	sich auf dem Holzweg befinden|sich im Irrtum befinden|einen Fehler machen|eine falsche Fährte verfolgen
pick myself up by my bootstraps	sich selbst wieder auf die Beine bringen|sich selbst wieder motivieren|sich selbst wieder aufrichten|sich selbst wieder ermutigen
pie in the sky	etwas, das sehr unwahrscheinlich ist|etwas, das unrealistisch ist|etwas, das zu schön ist, um wahr zu sein
Pandora's box	eine Büchse der Pandora öffnen|eine Lawine von Problemen auslösen|eine unerwartete Flut von Schwierigkeiten auslösen
to play it by ear	etwas spontan entscheiden|etwas improvisieren|etwas aus dem Bauch heraus entscheiden
through the wringer	jemanden hart rannehmen|jemanden gründlich prüfen|jemanden auf Herz und Nieren prüfen|jemanden auf die Probe stellen
you have to break a few eggs to make an omelette	Man muss Fehler machen, um etwas Neues zu lernen|Ohne Fleiß kein Preis|Ohne Risiko kein Gewinn|Man muss Opfer bringen, um Erfolg zu haben
a big softie	ein Weichei|ein Sensibelchen|ein Warmduscher
drop the ball	versagen|einen Fehler machen|einen Fehler begehen|einen Fehler machen, der schwerwiegende Konsequenzen hat
to play second fiddle	to take a subordinate role|to be less important|to be in a less favorable position|to be in a supporting role
not my cup of tea	nicht mein Ding|nicht meine Stärke|nicht meine Vorliebe|nicht mein Fall|nicht meine Welt
to bite the bullet	sich zusammenreißen|sich durchbeißen|etwas Unangenehmes auf sich nehmen|sich etwas antun|etwas durchstehen müssen
the ball rolling	etwas in Gang bringen|etwas in Bewegung setzen|den Anfang machen|den Startschuss geben
a piece of cake	ein Kinderspiel|sehr einfach|sehr leicht|kein Problem|NA
his word	sein Wort|seine Versprechen|seine Zusagen
her cool	ihre Ruhe bewahren|sich nicht aus der Fassung bringen lassen|gelassen bleiben|sich beherrschen
plan A	Plan A refers to the primary or preferred course of action or strategy.
making a mountain out of a molehill	aus einer Mücke einen Elefanten machen|eine Kleinigkeit aufbauschen|eine Lappalie dramatisieren|eine Nebensächlichkeit überbewerten
skeletons in his closet	Geheimnisse haben|Dinge verbergen, die niemand wissen soll|ein dunkles Geheimnis haben|ein Skelett im Schrank haben
hit the nail on the head	den Nagel auf den Kopf treffen|etwas genau richtig machen|etwas perfekt machen|etwas genau passend machen
bigger fish to fry	wichtigere Dinge zu tun haben|größere Probleme haben|sich um wichtigere Angelegenheiten kümmern müssen
it takes two to tango	Es gehören immer zwei dazu|Es braucht immer zwei zum Tanzen|Es sind immer zwei beteiligt
hit the hay	sich ausruhen|sich entspannen|ins Bett gehen|schlafen gehen
bats in his belfry	verrückt sein|nicht ganz bei Sinnen sein|einen Vogel haben|nicht ganz dicht sein|nicht alle Tassen im Schrank haben
hot under the collar	sich aufregen|sich ärgern|wütend sein|sich erhitzen|sich auf die Palme bringen lassen
smoke and mirrors	Täuschung|Blendwerk|Illusionen|Tricks|Schein
a chip on his shoulder	sich benachteiligt fühlen|sich ungerecht behandelt fühlen|sich provoziert fühlen|sich angegriffen fühlen
the icing on the cake	etwas, das eine ohnehin schon gute Sache noch besser macht|das Tüpfelchen auf dem i|das Sahnehäubchen auf dem Kuchen
a chip off the old block	ein Sprössling des alten Stammes|ein Abbild seines Vorgängers|ein Ebenbild seines Vorgängers|ein Kind seiner Eltern|ein Kind des alten Stammes
break a leg	viel Glück|alles Gute|viel Erfolg|du schaffst das|Sie schaffen das
tighten our belts	den Gürtel enger schnallen|sparen müssen|sich einschränken müssen|weniger Geld ausgeben können
barking up the wrong tree	falsch liegen|auf dem Holzweg sein|sich irren|einen Fehler machen
stick to her guns	an seinen Prinzipien festhalten|bei seiner Meinung bleiben|sich nicht beirren lassen|sich nicht umstimmen lassen
his heart set on	sich auf etwas festgelegt haben|sein Herz an etwas hängen|sich auf etwas eingeschossen haben
an uphill battle	ein harter Kampf|eine schwierige Aufgabe|eine Herausforderung|ein steiniger Weg
in over her head	überfordert sein|sich über den Kopf wachsen lassen|nicht mehr Herr der Lage sein|sich in etwas verrennen
with words	mit Worten|durch seine Wortwahl|durch seine Sprache
circumstances beyond our control	NA (This is not an idiomatic expression, it is a common phrase used to explain that the situation is out of our hands and we cannot do anything about it.)
her own business	ihr eigenes Geschäft|ihre eigene Firma|selbstständig werden|ein Unternehmen gründen
running around like a headless chicken	wie ein aufgescheuchtes Huhn herumlaufen|wie ein Huhn ohne Kopf herumlaufen|hektisch umherlaufen|verwirrt umherlaufen
the show	die Show|die Aufmerksamkeit auf sich ziehen|im Mittelpunkt stehen|die Hauptrolle spielen
food for thought	Denkanstoß|Anregung|Idee|Inspiration
between you and me	unter uns|vertraulich|nicht weitererzählen|nicht für die Öffentlichkeit bestimmt
take shape	Gestalt annehmen|Form annehmen|sich konkretisieren|sich abzeichnen
a litter of kittens	NA
roll with the punches	sich anpassen können|mit Rückschlägen umgehen können|flexibel bleiben|sich nicht unterkriegen lassen
To let the cat out of the bag	ein Geheimnis ausplaudern|etwas verraten, was geheim bleiben sollte|die Katze aus dem Sack lassen
between a rock and a hard place	in der Zwickmühle sein|zwischen zwei Stühlen sitzen|vor einem Dilemma stehen
knocking on wood	NA
your chickens before they're hatched	etwas als sicher annehmen, bevor es wirklich passiert ist|sich zu früh freuen|vorzeitig jubeln
nipped it in the bud	etwas im Keim ersticken|etwas frühzeitig beenden|etwas verhindern, bevor es schlimmer wird
spilled milk	vergangene Dinge|das Kind ist in den Brunnen gefallen|das ist Schnee von gestern|das ist nicht mehr zu ändern
ins and outs	alle Einzelheiten|alle Feinheiten|alle Details|alle Kniffe|alle Tricks
pick up the ball and run with it	weitermachen, wo man aufgehört hat|den Faden wieder aufnehmen|sich nahtlos wieder einfügen|sich sofort wieder zurechtfinden
put your best foot forward	sich von der besten Seite zeigen|sich von der Schokoladenseite präsentieren|einen guten Eindruck machen|sich von seiner besten Seite zeigen
Burning bridges	Brücken abbrechen|alle Brücken hinter sich abbrechen|sich selbst ins Aus schießen|sich selbst ins Knie schießen
beg, borrow or steal	etwas erbetteln, borgen oder stehlen müssen|etwas auf unehrliche Weise beschaffen müssen|etwas auf illegale Weise beschaffen müssen
let the chips fall where they may	alles auf eine Karte setzen|das Schicksal seinen Lauf nehmen lassen|es darauf ankommen lassen|die Dinge ihren Lauf nehmen lassen
walking the talk	den Worten Taten folgen lassen|seine Versprechen einhalten|seine Ankündigungen umsetzen|seine Versprechen in die Tat umsetzen
break the ice	das Eis brechen|das Schweigen brechen|den Anfang machen|das Gespräch beginnen
put our best foot forward	sich von der besten Seite zeigen|sein Bestes geben|sich ins Zeug legen|sich anstrengen|sich bemühen
play it by ear	etwas improvisieren|etwas spontan entscheiden|etwas flexibel handhaben
bee in his bonnet	fixe Idee|fixation|Wahnvorstellung|Besessenheit|fixiert auf etwas sein
separating the wheat from the chaff	die Spreu vom Weizen trennen
putting money aside for a rainy day	für schlechte Zeiten vorsorgen|für Notfälle sparen|für unvorhergesehene Ausgaben sparen
call it a day	für heute Schluss machen|den Tag beenden|aufhören für heute|fertig sein für heute
on cloud nine	im siebten Himmel sein|überglücklich sein|sehr glücklich sein|sich wie im Paradies fühlen
spice things up	etwas aufpeppen|etwas würzen|etwas interessanter machen|etwas spannender machen
at home	sich wie zu Hause fühlen|sich wohl fühlen|sich geborgen fühlen
seize the day	den Tag nutzen|die Gelegenheit beim Schopf packen|die Chance ergreifen|nicht zögern, sondern handeln
nodding off	einnicken|wegdösen|einschlafen|schlummern|schlafen gehen
like a duck to water	sich wie ein Fisch im Wasser fühlen|sich pudelwohl fühlen|sich wie zu Hause fühlen
hit the books	sich ins Studium stürzen|sich ins Lernen stürzen|sich ins Büffeln stürzen|sich ins Pauken stürzen
bounce back	sich erholen|sich wieder erholen|sich wieder erholen|sich wieder erholen|sich wieder erholen|sich wieder erholen|sich wieder erholen|sich wieder erholen|sich wieder erholen|sich wieder erholen|sich wieder erholen|sich wieder erholen|sich wieder erholen|sich wieder erholen|sich wieder
building castles in the air	Luftschlösser bauen|Träumereien haben|unrealistische Pläne schmieden
fighting chance	kleine Chance|Außenseiterchance|kleine Möglichkeit|kleine Gelegenheit|kleine Hoffnung
my back	jemanden unterstützen|jemandem den Rücken stärken|jemandem beistehen|jemandem helfen|jemandem zur Seite stehen
coming up roses	alles läuft bestens|alles läuft wie am Schnürchen|alles läuft wie geschmiert|alles läuft wie geplant|alles läuft reibungslos
golden touch	eine goldene Stimme haben|ein goldenes Händchen haben|ein besonderes Talent haben|etwas besonders gut können
hit the ground running	start working effectively and successfully from the beginning|start with great energy and enthusiasm and make rapid progress
cut to the chase	zur Sache kommen|zum Wesentlichen kommen|zum Punkt kommen|zur Kernfrage übergehen
stranger than fiction	unglaublich|verblüffend|erstaunlich|faszinierend|überraschend
keep an eye on them	aufpassen|beobachten|überwachen|im Auge behalten
digs in her heels	sich stur stellen|sich starrköpfig zeigen|sich unnachgiebig zeigen|sich festbeißen|sich verbeißen|sich festlegen|sich festfahren
let out a sigh of relief	einen Seufzer der Erleichterung ausstoßen
down the drain	verloren sein|vor dem Aus stehen|vor dem Bankrott stehen|vor dem Zusammenbruch stehen
cost an arm and a leg	sehr teuer sein|ein Vermögen kosten|sehr kostspielig sein
bend over backwards	sich sehr anstrengen|sich sehr bemühen|sich ins Zeug legen|sich Mühe geben|sich abrackern
sit well with me	sich gut anfühlen|sich richtig anfühlen|sich stimmig anfühlen|sich passend anfühlen|sich angenehm anfühlen|sich wohl fühlen
In a nutshell	um es kurz zu machen|zusammenfassend|kurz gesagt|in Kürze|in aller Kürze
green around the gills	bleich um die Nase|übel|krank|nervös|unsicher
chip on his shoulder	sich ständig angegriffen fühlen|sich ständig provoziert fühlen|sich ständig benachteiligt fühlen
keep your chin up	den Kopf hochhalten|nicht aufgeben|sich nicht unterkriegen lassen|durchhalten|durchbeißen
dropped the ball	versagt|einen Fehler machen|einen Fehler begehen|eine Aufgabe nicht erfüllen|eine Aufgabe vernachlässigen
put all his eggs in one basket	alles auf eine Karte setzen|alles auf ein Pferd setzen|alles auf eine Möglichkeit setzen
see eye to eye	auf einer Wellenlänge sein|übereinstimmen|einer Meinung sein|gleicher Ansicht sein
right up my alley	etwas liegt mir|etwas ist mein Ding|etwas ist genau mein Fall|etwas ist genau mein Gebiet|etwas ist genau mein Ding
beating a dead horse	etwas vergeblich versuchen|eine Sache unnötig weiterverfolgen|eine tote Sache weiterverfolgen
have a cow	sich aufregen|ausflippen|sich auf den Schlips getreten fühlen|sich tierisch ärgern
threw in the towel	aufgeben|das Handtuch werfen|sich geschlagen geben|kapitulieren
lean on her	sich auf sie verlassen können|sich auf sie stützen können|sich auf sie ausruhen können|sich auf sie vertrauen können
hammer out	eine Lösung ausarbeiten|eine Lösung erarbeiten|eine Lösung mühsam erzielen
to go the extra mile	sich besonders anstrengen|sich besonders bemühen|sich besonders engagieren|sich besonders ins Zeug legen
stolen her thunder	jemandem die Show stehlen|jemandem den Ruhm wegnehmen|jemandem die Idee klauen
caught between a rock and a hard place	in der Klemme stecken|zwischen zwei Stühlen sitzen|vor einer schwierigen Entscheidung stehen|in einer schwierigen Lage sein
fallen flat	gescheitert sein|nicht funktioniert haben|keinen Erfolg gehabt haben|nicht gut angekommen sein
to bite off more than I can chew	sich übernehmen|zu viel auf einmal wollen|sich zu viel zumuten|sich überfordern
up in the air	unsicher|unklar|unvorhersehbar|in der Schwebe|in der Luft|ungewiss
up in smoke	gescheitert|verloren|zunichte gemacht|umsonst|vergeblich
dead in the water	keine Fortschritte machen|scheitern|nicht weiterkommen|stecken bleiben|ins Stocken geraten
sink in	sich setzen|verdauen|einwirken lassen|sich festsetzen
to hit the hay	ins Bett gehen|sich schlafen legen|zu Bett gehen|sich zur Ruhe begeben
running around like a chicken with its head cut off	wie ein aufgescheuchtes Huhn herumlaufen|wie ein kopfloses Huhn herumlaufen|hektisch umherlaufen|planlos umherlaufen
behind the eight ball	in Schwierigkeiten sein|in Verzug sein|in Rückstand sein|unter Druck stehen
in a rut	in einer Sackgasse stecken|in einer festgefahrenen Situation stecken|in einer Routine gefangen sein
to butter me up	mir Honig ums Maul schmieren|sich bei mir einschmeicheln|mir Komplimente machen, um etwas von mir zu bekommen
the ground running	schnell und erfolgreich anfangen|schnell und erfolgreich arbeiten|schnell und erfolgreich Fortschritte machen
the whole nine yards	alles geben|keine halben Sachen machen|bis zum Äußersten gehen|alles tun, was möglich ist
a clean slate	einen Neuanfang machen|einen Schlussstrich ziehen|von vorne anfangen|einen Neustart wagen
put the cart before the horse	etwas in der falschen Reihenfolge tun|etwas vorwegnehmen, bevor es an der Zeit ist|den zweiten Schritt vor dem ersten machen
the box	die gewohnten Denkmuster|eingefahrene Denkweisen|eingeschränkte Sichtweise
bite off more than I can chew	sich übernehmen|sich zu viel zumuten|sich überfordern|sich zu viel vornehmen
her pride	ihr Ego|ihre Selbstachtung|ihre Würde
in no time	im Handumdrehen|sehr schnell|ohne Verzögerung|in kürzester Zeit
keep our eyes peeled	aufmerksam bleiben|wachsam sein|die Augen offen halten|vorsichtig sein
to wrap his head around	etwas begreifen|etwas verstehen|etwas nachvollziehen|etwas erfassen
early bird catches the worm	Der frühe Vogel fängt den Wurm.
put their nose to the grindstone	sich ins Zeug legen|sich anstrengen|sich konzentrieren|sich bemühen|sich Mühe geben|sich ins Schwitzen bringen
to cut to the chase	direkt auf den Punkt kommen|zum Wesentlichen kommen|kein Blatt vor den Mund nehmen
whole new ballgame	etwas völlig Neues|eine ganz neue Herausforderung|ein neues Kapitel
to pull your leg	jemanden auf den Arm nehmen|jemanden veräppeln|jemanden zum Narren halten
to keep their chin up	sich nicht unterkriegen lassen|durchhalten|optimistisch bleiben|nicht aufgeben
take the backseat	sich zurückhalten|sich zurückziehen|sich im Hintergrund halten|sich nicht in den Vordergrund drängen
strike while the iron is hot	die Gelegenheit beim Schopf packen|die Gunst der Stunde nutzen|eine Chance ergreifen, solange sie sich bietet
breathe easy	sich entspannen|aufatmen|sich beruhigen|sich zurücklehnen
a spoonful of sugar	etwas Angenehmes, das eine unangenehme Situation erträglicher macht|etwas Positives, das eine negative Situation verbessert
in the red	im Minus sein|Verluste machen|defizitär sein
feel under the weather	sich schlapp fühlen|sich unwohl fühlen|sich kränklich fühlen|sich nicht wohl fühlen
hits the nail on the head	den Nagel auf den Kopf treffen|ins Schwarze treffen|genau richtig liegen|richtig vorhersagen
of leeway	Spielraum|Freiheit|Spielraum für Kreativität|Freiheit für Kreativität
in due course	zur rechten Zeit|zur gegebenen Zeit|zum richtigen Zeitpunkt|früher oder später|mit der Zeit
spill the beans	ausplaudern|ausposaunen|etwas verraten|ein Geheimnis ausplaudern
Bite the bullet	Sich zusammenreißen|Sich durchbeißen|Sich durchringen|Sich überwinden|Sich etwas abverlangen
keep their eyes peeled	aufmerksam bleiben|wachsam bleiben|die Augen offen halten|Acht geben|vorsichtig sein
put our noses to the grindstone	sich ins Zeug legen|sich an die Arbeit machen|sich anstrengen|sich konzentrieren|sich bemühen|sich reinhängen
turn the tables	die Karten neu mischen|das Blatt wenden|die Situation umdrehen|den Spieß umdrehen
fall through	scheitern|nicht zustande kommen|nicht klappen|nicht funktionieren
keep the ball rolling	den Ball am Rollen halten|den Fortschritt aufrechterhalten|die Dinge in Bewegung halten|den Schwung aufrechterhalten
let the cat out of the bag	ein Geheimnis ausplaudern|etwas ausplaudern|etwas verraten|etwas ausposaunen
hang in there	durchhalten|durchbeißen|durchstehen|durchstehen bis es besser wird
a blur	eine verschwommene Erinnerung|eine verschwommene Vorstellung|eine verschwommene Erinnerung an etwas haben|etwas nicht klar erinnern können
pull the wool over people's eyes	jemanden hinters Licht führen|jemanden täuschen|jemanden betrügen|jemanden an der Nase herumführen
dropping the ball	einen Fehler machen|eine Chance verpassen|eine Gelegenheit verpassen|einen Fehler begehen|eine Aufgabe nicht erfüllen|eine Aufgabe vernachlässigen
pull himself together	sich zusammenreißen|sich sammeln|sich fangen|sich beruhigen|sich wieder unter Kontrolle bringen
rat race	ein Wettlauf, bei dem alle Teilnehmer hart arbeiten, um erfolgreich zu sein, aber nur einer gewinnt|ein Wettlauf, bei dem der Erfolg auf Kosten der Gesundheit und des Wohlbefindens erreicht wird
to hit the ground running	voller Begeisterung angehen|enthusiastisch angehen|hart und erfolgreich arbeiten
spot on	vollkommen richtig|genau richtig|absolut korrekt|voll ins Schwarze treffen
stringing her along	jemanden hinhalten|jemanden vertrösten|jemanden vertrödeln|jemanden auf die lange Bank schieben
a cash cow	eine Goldgrube|eine Gelddruckmaschine|eine lukrative Einnahmequelle|ein lukratives Geschäft
traffic jam	Verkehrsstau|Verkehrsbehinderung|Verkehrskollaps|Verkehrschaos
went the whole nine yards	alles geben|sich voll reinhängen|alles tun, was möglich ist|keine halben Sachen machen
let sleeping dogs lie	Es ist besser, die Dinge unangetastet zu lassen|Es ist besser, die Dinge ruhen zu lassen|Es ist besser, die Dinge so zu lassen, wie sie sind|Es ist besser, nichts zu unternehmen, um eine schlechte Situation nicht noch schlimmer zu machen
dot our i's and cross our t's	alles genau und sorgfältig machen|keine Fehler machen|alles genau prüfen und überprüfen|alles akribisch durchgehen
paint the town red	die Nacht zum Tag machen|feiern gehen|sich amüsieren gehen|die Stadt unsicher machen
pulled myself up by my bootstraps	sich am eigenen Schopf aus dem Sumpf ziehen|sich selbst aus einer schwierigen Situation befreien|sich selbst motivieren und anstrengen, um erfolgreich zu sein
bail out	aussteigen|sich zurückziehen|aufgeben|fliehen|sich aus der Affäre ziehen
point him in the right direction	ihm den richtigen Weg zeigen|ihm helfen, sich zurechtzufinden|ihm helfen, die richtige Entscheidung zu treffen
to keep a stiff upper lip	die Fassung bewahren|sich nichts anmerken lassen|tapfer bleiben|standhaft bleiben
sleep on it	eine Nacht darüber schlafen|sich Bedenkzeit nehmen|eine Entscheidung aufschieben|etwas reifen lassen
fish out of water	sich unwohl fühlen|sich fehl am Platz fühlen|sich wie ein Fisch auf dem Trockenen fühlen
a laugh riot	eine Lachnummer|zum Brüllen komisch|sehr lustig|ein riesiger Spaß
make or break	entscheidend sein|über Erfolg oder Misserfolg entscheiden|alles aufs Spiel setzen|es geht um alles oder nichts
let off steam	Dampf ablassen|sich abreagieren|sich austoben|sich abreagieren
click with you	sich einprägen|verstehen|klar werden|sich einleuchten|sich erschließen
slow as molasses	sehr langsam|sehr träge|sehr zähflüssig|sehr schleppend
flat as a pancake	völlig gescheitert|ohne Erfolg|erfolglos|ohne Ergebnis
calls the shots	das Sagen haben|die Entscheidungen treffen|bestimmen, was passiert
talk the hind legs off a donkey	sehr viel reden|jemandem die Ohren abkauen|jemandem die Ohren vollquatschen|jemandem die Ohren abquatschen|jemandem die Ohren abnudeln
fly off the handle	schnell wütend werden|aus der Haut fahren|sich aufregen|explodieren|schnell reizbar sein
throw in the towel	aufgeben|die Flinte ins Korn werfen|das Handtuch werfen|sich geschlagen geben
bite your tongue	sich auf die Zunge beißen|sich zurückhalten|sich beherrschen|den Mund halten
to get a foot in the door	einen Fuß in die Tür bekommen|einen Einstieg finden|sich einen Platz verschaffen|sich etablieren
let their hair down	sich gehen lassen|sich entspannen|sich amüsieren|sich vergnügen
have a chip on her shoulder	sich immer angegriffen fühlen|sich immer benachteiligt fühlen|sich immer provoziert fühlen|sich immer beleidigt fühlen
to keep their heads above water	sich über Wasser halten|überleben|nicht untergehen|nicht scheitern|nicht aufgeben
beating around the bush	um den heißen Brei herumreden|nicht auf den Punkt kommen|sich in Ausflüchten verlieren
to keep my chin up	nicht den Mut verlieren|sich nicht unterkriegen lassen|durchhalten|optimistisch bleiben
started to butt heads	aneinandergeraten|sich in die Haare kriegen|sich streiten|auseinandergehen
to move the goalposts	to change the rules|to change the criteria|to change the expectations|to change the standards
let bygones be bygones	Vergangenes ruhen lassen|das Alte hinter sich lassen|Gräben zuschütten|einen Schlussstrich ziehen|einen Neuanfang wagen
keep all her ducks in a row	alles im Griff haben|alles unter Kontrolle haben|gut organisiert sein|gut strukturiert sein
laugh his head off	sich kaputtlachen|sich totlachen|sich schlapp lachen|sich kringeln vor Lachen
jump out of her skin	vor Ungeduld platzen|sich nicht mehr im Zaum halten können|sich nicht mehr beherrschen können
at a snail's pace	sehr langsam|im Schneckentempo|mit sehr geringer Geschwindigkeit|sehr schleppend|sehr zäh
come out of his shell	aus sich herauskommen|sich öffnen|sich entfalten|selbstbewusster werden
get one's act together	sich zusammenreißen|sich sammeln|sich konzentrieren|sich organisieren|sich vorbereiten
as cool as a cucumber	so gelassen wie eine Gurke|ruhig und besonnen|sehr entspannt und gelassen|kühl und ruhig
a wild-goose chase	eine Schnitzeljagd|eine sinnlose Suche|eine vergebliche Mühe|eine Zeitverschwendung
keep the wolf from the door	sich über Wasser halten|sich über Wasser halten müssen|finanziell kämpfen müssen|finanziell überleben müssen
she has ants in her pants	Sie kann nicht stillsitzen|Sie ist unruhig|Sie ist hibbelig|Sie ist nervös
putting all their eggs in one basket	alles auf eine Karte setzen|alles auf ein Pferd setzen|alles auf eine Strategie setzen
get a foot in the door	sich in etwas hineindrängen wollen|sich in etwas einmischen wollen|sich in etwas einschleichen wollen|sich in etwas hineinzwängen wollen
burn the midnight oil	bis spät in die Nacht arbeiten|die Nacht durchmachen|nächtelang arbeiten|bis in die Puppen arbeiten
feather in her cap	eine große Leistung|ein großer Erfolg|eine besondere Errungenschaft|eine besondere Auszeichnung
turn over a new leaf	ein neues Kapitel aufschlagen|einen Neuanfang machen|sich ändern|sich bessern
have his cake and eat it too	Das Beste aus beiden Welten haben wollen|Sowohl das eine als auch das andere wollen, obwohl es nicht möglich ist|Den Kuchen behalten und ihn trotzdem essen wollen
weight off her shoulders	eine Last von den Schultern nehmen|sich erleichtert fühlen|sich befreit fühlen
better than a poke in the eye with a sharp stick	besser als nichts|immerhin etwas|es könnte schlimmer sein|es ist besser als gar nichts
ballpark figure	ungefährer Betrag|Pi mal Daumen|geschätzter Betrag
all your eggs in one basket	alles auf ein Pferd setzen|alles auf eine Karte setzen
actions speak louder than words	Taten sagen mehr als Worte|Nicht Worte, sondern Taten zählen|Handlungen sprechen lauter als Worte
with a pinch of salt	mit Vorsicht genießen|mit Skepsis betrachten|nicht alles für bare Münze nehmen
tied to the apron strings	an der Schürze hängen|zu sehr von den Eltern abhängig sein|nicht selbstständig sein
off the top of his head	aus dem Stegreif|ohne Vorbereitung|ohne nachzudenken|ohne Planung
knock on wood	auf Holz klopfen|sich gegen Unglück absichern|sich Glück wünschen
music to my ears	Musik in meinen Ohren|Musik für meine Ohren|genau das, was ich hören wollte|genau das, was ich hören musste
in hot water	in Schwierigkeiten|in Bedrängnis|in Not|in einer misslichen Lage
couch potato	Couch-Potato|Faulenzer|Faulpelz|Trödler|Nichtstuer
went their separate ways	sich trennen|sich aufteilen|getrennte Wege gehen
to look on the bright side	das Positive sehen|optimistisch sein|die Dinge positiv betrachten|die Sonnenseite sehen
to keep my head above water	sich über Wasser halten|sich über Wasser halten können|nicht untergehen|nicht untergehen können|sich behaupten|sich durchschlagen
her bridges	alle Brücken hinter sich abbrechen|sich ins Aus schießen|sich ins Abseits manövrieren|sich selbst ins Knie schießen
burning a hole in my pocket	das Geld brennt mir in der Tasche|ich kann das Geld nicht lange behalten|ich gebe das Geld schnell aus
set in his ways	festgefahren|eingefahren|stur|unbelehrbar|unflexibel
to play fast and loose	sich nicht an Regeln halten|sich über Regeln hinwegsetzen|sich nicht an Vereinbarungen halten|unzuverlässig sein
to throw in the towel	aufgeben|das Handtuch werfen|sich geschlagen geben|kapitulieren
cold shoulder	jemanden ignorieren|jemanden abweisen|jemanden abblocken|jemanden abwimmeln
big fish in a small pond	jemand, der in einem begrenzten Umfeld groß rauskommen will|jemand, der in einem begrenzten Umfeld übertrieben wichtig tut
burning the midnight oil	bis spät in die Nacht arbeiten|die Nacht durchmachen|nächtelang arbeiten|die Nacht zum Tag machen
damp squib	etwas, das enttäuschend oder erfolglos ist|ein Reinfall|eine Enttäuschung|eine Pleite
keep my chin up	nicht den Mut verlieren|sich nicht unterkriegen lassen|durchhalten|optimistisch bleiben
take the rap	die Schuld auf sich nehmen|die Verantwortung übernehmen|die Konsequenzen tragen
getting the hang of it	sich schnell einarbeiten|sich schnell zurechtfinden|sich schnell anpassen|sich schnell an die Arbeit gewöhnen
in over my head	überfordert sein|nicht mehr weiterwissen|nicht mehr Herr der Lage sein|sich über den Kopf gewachsen sein
cool head	ruhiges Gemüt|Gelassenheit|Nerven wie Drahtseile|kühler Kopf|Besonnenheit
life of the party	Mittelpunkt der Party|Stimmungsmacher|Partylöwe|Partymaus
noses to the grindstone	sich ins Zeug legen|hart arbeiten|sich anstrengen|sich bemühen|sich konzentrieren
bigger picture	das große Ganze|die Gesamtsituation|der Gesamtzusammenhang|die langfristigen Auswirkungen
get on the same page	sich einigen|auf einen Nenner kommen|auf einer Wellenlänge sein|sich verständigen
off the cuff	aus dem Stegreif|ohne Vorbereitung|spontan|ungeplant
her all	ihr Bestes|alles, was sie hatte|ihre ganze Kraft|ihre ganze Energie|ihre ganze Ausdauer
to sweeten the pot	etwas attraktiver machen|ein Angebot verbessern|ein Angebot aufwerten|einen Anreiz schaffen
bought hook, line and sinker	etwas bedingungslos glauben|etwas ohne Vorbehalt akzeptieren|etwas vollständig schlucken|etwas völlig übernehmen
to go the distance	bis zum Ende durchhalten|bis zum Schluss durchhalten|durchhalten, bis das Ziel erreicht ist|bis zum Ziel kommen|das Ziel erreichen
to treat yourself	sich etwas gönnen|sich verwöhnen|sich belohnen|sich etwas Besonderes gönnen
spinning our wheels	keine Fortschritte machen|auf der Stelle treten|nicht weiterkommen|sich im Kreis drehen
silver lining	Hoffnungsschimmer|positive Seite|gutes Ende|positive Aussicht|positive Wendung
to hit the nail on the head	den Nagel auf den Kopf treffen|ins Schwarze treffen|genau richtig sein|etwas auf den Punkt bringen
with a chip on her shoulder	mit einer beleidigten Leberwurst-Stimmung|mit einer schlechten Laune|mit einer negativen Einstellung|mit einer feindseligen Haltung
with a grain of salt	mit Vorsicht genießen|mit Skepsis betrachten|nicht alles für bare Münze nehmen|nicht alles ernst nehmen
to play devil's advocate	den Advocatus Diaboli spielen|eine Gegenposition einnehmen|eine kontroverse Position einnehmen|eine provokante Position einnehmen
a social butterfly	ein geselliger Mensch|ein Partygänger|ein extrovertierter Mensch|ein Schmetterling der Gesellschaft
the benefit of the doubt	der Zweifel zugunsten des Angeklagten|jemandem das Wohlwollen entgegenbringen|jemandem vertrauen, obwohl man nicht sicher ist, ob er/sie die Wahrheit sagt
a bitter pill to swallow	eine harte Pille zum Schlucken|etwas Schweres, das man akzeptieren muss|etwas Unangenehmes, das man ertragen muss
a fish out of water	sich fremd fühlen|sich unwohl fühlen|sich wie ein Fisch auf dem Trockenen fühlen
sell it like hotcakes	sich wie warme Semmeln verkaufen|schnell und erfolgreich verkauft werden|sehr beliebt sein|reißenden Absatz finden
pull out all the stops	alle Register ziehen|keine Mühen scheuen|alles geben|sich voll ins Zeug legen
all hat, no cattle	viel Wind um nichts machen|viel Lärm um nichts|große Töne spucken, aber nichts dahinter haben
to pass up	ablehnen|vorbeigehen lassen|nicht wahrnehmen|nicht nutzen
to stay ahead of the game	sich einen Vorteil verschaffen|sich einen Wettbewerbsvorteil verschaffen|sich einen Vorsprung verschaffen|sich einen Vorsprung erarbeiten
to turn over a new leaf	eine neue Seite aufschlagen|einen Neuanfang machen|sich ändern|sich bessern
drop in the bucket	something small or insignificant compared to what is needed or expected|ein Tropfen auf den heißen Stein
sticker shock	Preisschock|Preisüberraschung|Preisentsetzen
take a rain check	verschieben|auf später verschieben|einen neuen Termin vereinbaren|später treffen
has her ducks in a row	alles im Griff haben|gut organisiert sein|gut vorbereitet sein|gut strukturiert sein
jump on the bandwagon	sich anschließen|mitmachen|sich einer Sache anschließen|sich einer Bewegung anschließen|sich einer Mode anschließen
cross the finish line	das Ziel erreichen|erfolgreich abschließen|den Durchbruch schaffen
butterflies in his stomach	Lampenfieber haben|nervös sein|sich unwohl fühlen|Herzklopfen haben
lick my wounds	meine Wunden lecken|meine Verletzungen heilen|meine Enttäuschung verarbeiten|meine Trauer bewältigen
kill two birds with one stone	zwei Fliegen mit einer Klappe schlagen
red herrings	Ablenkungen|Irrwege|falsche Fährten|Sackgassen
of the essence	von entscheidender Bedeutung|wichtig|essentiell|unverzichtbar|unerlässlich
she missed the boat	sie hat den Zug verpasst|sie hat die Gelegenheit verpasst|sie hat den Anschluss verloren
the bush	um den heißen Brei herumreden|sich nicht klar ausdrücken|nicht auf den Punkt kommen
a fly in the ointment	ein Haken|ein Problem|eine Schwierigkeit|ein Hindernis|eine Unannehmlichkeit
you're tilting at windmills	you're fighting a losing battle|you're wasting your time|you're pursuing an unrealistic goal|you're chasing an illusion
keep an eye on him	ein Auge auf ihn haben|ihn im Auge behalten|wachsam sein|aufpassen
moving the goalposts	das Ziel ändern|die Spielregeln ändern|die Anforderungen ändern|die Erwartungen ändern
playing both sides	mit beiden Seiten spielen|doppeltes Spiel spielen|sich nicht festlegen wollen|sich nicht entscheiden können
robbing Peter to pay Paul	Geld von einer Stelle zur anderen umleiten|Peter berauben, um Paul zu bezahlen|eine Schuldenfalle vermeiden wollen
cold feet	zweifelnd sein|zurückhaltend sein|unsicher sein|Angst haben|Bedenken haben
up the creek without a paddle	in Schwierigkeiten stecken|in der Klemme sitzen|in einer misslichen Lage sein|keinen Ausweg haben|verloren sein
silver spoon in her mouth	sie hatte es von Geburt an leicht|sie hatte es von Geburt an besser|sie hatte es von Geburt an privilegiert|sie hatte es von Geburt an leichter als andere|sie hatte es von Geburt an einfacher als andere|sie hatte es von Geburt an besser als andere
hitting the hay	ins Bett gehen|sich schlafen legen|sich ausruhen|sich erholen
the real McCoy	echt|authentisch|original|wirklich gut
stirring the pot	Unruhe stiften|Streit anfachen|für Unruhe sorgen|für Aufregung sorgen
take the bull by the horns	die Sache in die Hand nehmen|den Stier bei den Hörnern packen|entschlossen handeln|sich einer Herausforderung stellen
live it up	sich etwas gönnen|sich etwas leisten|sich etwas Besonderes gönnen|sich etwas Luxuriöses gönnen
back in the saddle	wieder im Sattel sitzen|wieder auf dem Damm sein|wieder fit sein|wieder bereit sein, neue Herausforderungen anzunehmen
jump ship	den Job wechseln|den Arbeitgeber wechseln|kündigen und eine neue Stelle suchen
play my cards right	etwas geschickt anstellen|etwas klug angehen|etwas geschickt machen|etwas klug machen
pushing the envelope	etwas Neues wagen|Grenzen austesten|sich an Grenzen wagen|sich an Grenzen herantasten
get off her high horse	vom hohen Ross herunterkommen|sich nicht mehr so wichtig nehmen|sich bescheiden
cut corners	einen Umweg machen|eine Abkürzung nehmen|einsparen|sparen an der falschen Stelle
put your nose to the grindstone	sich ins Zeug legen|sich anstrengen|hart arbeiten|sich konzentrieren|sich aufraffen|sich zusammenreißen
flies off the handle	sich aufregen|sich auf die Palme bringen lassen|aus der Haut fahren|sich aufblasen|sich aufplustern
go back to square one	wieder von vorne anfangen|nochmal von vorne beginnen|zurück auf Anfang gehen
hit rock bottom	am Tiefpunkt angelangt sein|den absoluten Tiefpunkt erreicht haben|sich am Boden befinden|sich in einer sehr schlechten Lage befinden
point me in the right direction	mir den Weg weisen|mir helfen, die richtige Richtung zu finden|mir einen Hinweis geben, wie ich vorgehen soll
the name of the game	die Realität|das Wesen der Sache|die Spielregeln|die Gepflogenheiten
rocket science	etwas sehr Kompliziertes|etwas sehr Schwieriges|etwas sehr Komplexes|etwas sehr Herausforderndes
hold my horses	Geduld haben|sich zurückhalten|sich beruhigen|nicht voreilig handeln
in the dark	im Dunkeln tappen|keine Ahnung haben|nicht verstehen|nicht durchblicken
go the extra mile	sich besonders anstrengen|sich besonders bemühen|einen Schritt weitergehen|sich besonders engagieren
kick the bucket	sterben|das Zeitliche segnen|ableben|davon scheiden|ins Gras beißen|den Löffel abgeben
burn that bridge when we come to it	etwas aufschieben|etwas später entscheiden|etwas später angehen|etwas später klären
brick wall	eine Sackgasse|eine Blockade|ein Hindernis|eine Hürde|ein Rückschlag
chicken out	sich drücken|sich vor etwas drücken|sich feige verhalten|einen Rückzieher machen|einknicken
have butterflies in his stomach	sich unwohl fühlen|sich nervös fühlen|sich aufgeregt fühlen|sich mulmig fühlen|Herzklopfen haben
a chip on my shoulder	ein Vorurteil haben|eine vorgefasste Meinung haben|voreingenommen sein|skeptisch sein|misstrauisch sein
laugh their head off	sich kaputtlachen|sich totlachen|sich halbtotlachen|sich kringeln vor Lachen
all hands on deck	alle Mann an Bord|alle Kräfte mobilisieren|jeder ist gefragt|alle müssen mit anpacken
under wraps	geheim halten|vertraulich behandeln|nicht ausplaudern|nicht verraten
to beat around the bush	um den heißen Brei herumreden|nicht auf den Punkt kommen|sich in Ausflüchten verlieren
wet behind the ears	unerfahren|grün hinter den Ohren|noch nicht lange dabei|noch nicht viel Erfahrung haben
in order	geregelt|in Ordnung|geordnet|organisiert
nip it in the bud	etwas im Keim ersticken|etwas frühzeitig unterbinden|etwas von Anfang an verhindern
took the plunge	sich trauen|den Schritt wagen|sich entscheiden, etwas zu tun, das Risiken birgt
bring home the bacon	Erfolg haben|Erfolge erzielen|Erfolge vorweisen können|Erfolge erlangen
big break	großer Durchbruch|Chance des Lebens|Erfolgserlebnis|Karrieresprungbrett
out of the blue	plötzlich|unerwartet|aus heiterem Himmel|ohne Vorwarnung
blank out	einen Blackout haben|einen Aussetzer haben|einen Gedächtnisausfall haben|einen Hänger haben
feeling under the weather	sich schlapp fühlen|sich unwohl fühlen|krank fühlen|nicht auf der Höhe sein|angeschlagen sein
sit on her hands	nichts tun|untätig sein|nichts unternehmen|nichts in Angriff nehmen
went out the window	verschwanden|verflogen|waren wie weggeblasen|waren vergessen|waren nicht mehr präsent
feeling jittery	nervös sein|unruhig sein|zappelig sein|sich aufgeregt fühlen
by the wayside	scheitern|nicht zustande kommen|nicht realisiert werden|nicht umgesetzt werden|nicht klappen
get away from it all	sich zurückziehen|sich erholen|sich entspannen|sich ausklinken|sich abkapseln
cash cow	Goldesel|Einnahmequelle|Gelddruckmaschine
off the charts	außerordentlich|unglaublich|außergewöhnlich|herausragend|unvergleichlich
to heart	persönlich nehmen|zu Herzen nehmen
flash in the pan	Eintagsfliege|kurzlebiges Phänomen|Strohfeuer|kurzfristiger Erfolg ohne Nachhaltigkeit
dogged determination	hartnäckige Entschlossenheit|unbeirrbare Entschlossenheit|unerschütterliche Entschlossenheit
meeting of the minds	Übereinkunft|Einigung|Konsens|Überstimmung
burn any bridges	alle Türen offen halten|keine Brücken hinter sich abbrechen|keine Feinde machen
bite my tongue	sich zurückhalten|sich beherrschen|sich zusammenreißen|den Mund halten|nichts sagen|sich zurücknehmen
to break the ice	das Eis brechen|das Eis zum Schmelzen bringen|den ersten Schritt machen|das Schweigen brechen
to clean house	to make a clean sweep|to get rid of corruption or inefficiency in an organization|to eliminate unnecessary or unwanted things or people
to call it a day	aufgeben|es sein lassen|Schluss machen|beenden|aufhören
walking on eggshells	sich vorsichtig verhalten|auf Zehenspitzen gehen|sich unsicher fühlen|sich in einer schwierigen Lage befinden
fair weather	gutes Wetter|schönes Wetter|Sonnenschein|gute Zeiten|gute Bedingungen
to get our foot in the door	einen Fuß in die Tür bekommen|einen Einstieg finden|sich Zugang verschaffen
count her chickens before they hatched	sich zu früh freuen|den Tag vor dem Abend loben|vorzeitig jubeln|vorzeitig feiern
Burning the midnight oil	bis spät in die Nacht arbeiten|die Nacht durchmachen|nächtelang arbeiten|die Nacht zum Tag machen
keep your head above water	über Wasser halten|sich über Wasser halten|nicht untergehen|nicht untergehen lassen|überleben|durchhalten|durchkommen
put two and two together	zusammenzählen|zusammenreimen|zusammenfügen|zusammenbringen
black and white	einfach|klar|unmissverständlich|schwarz-weiß-Denken
missed the boat	eine Chance verpasst haben|zu spät sein|den Zug verpasst haben|eine Gelegenheit verpasst haben
fast learner	schnelle Auffassungsgabe|schnell lernend|schnell begreifend|schnell verständig
let it all hang out	sich gehen lassen|sich fallen lassen|sich gehen lassen und alles sagen, was man denkt oder fühlt
walk the walk	Taten sprechen lauter als Worte|Nicht nur reden, sondern handeln|Worte in Taten umsetzen
your foot in the door	einen Fuß in der Tür haben|einen Einstieg finden|eine Chance bekommen|eine Möglichkeit ergreifen
get our ducks in a row	unsere Sachen ordnen|unsere Angelegenheiten in Ordnung bringen|unsere Vorbereitungen treffen|unsere Pläne koordinieren
to have her cake and eat it too	das Beste aus beiden Welten haben wollen|sich nicht entscheiden wollen|beides wollen, ohne Kompromisse einzugehen
have bigger fish to fry	größere Probleme haben|größere Sorgen haben|vor größeren Herausforderungen stehen
let my hair down	sich entspannen|sich gehen lassen|sich locker machen|sich ausruhen
has a heart of gold	ein Herz aus Gold haben|ein sehr gutes Herz haben|sehr freundlich und großzügig sein
put my two cents in	meinen Senf dazugeben|meine Meinung sagen|meinen Beitrag leisten|meinen Standpunkt vertreten
the pedal to the metal	sich ins Zeug legen|Gas geben|sich anstrengen|sich bemühen|sich Mühe geben
spilling the beans	ausplaudern|ein Geheimnis verraten|etwas ausplaudern|etwas verraten
outside the box	kreativ|unorthodox|ungewöhnlich|neuartig|originell|innovativ
a thorn in my side	ein Dorn im Auge|ein Ärgernis|ein Hindernis|ein Problem|ein Störfaktor
making waves	für Aufsehen sorgen|für Furore sorgen|für Wirbel sorgen|für Begeisterung sorgen
lame duck	schwache Ausrede|unglaubwürdige Entschuldigung|faule Ausrede
all mouth and no trousers	viel Wind um nichts machen|große Töne spucken|viel versprechen und wenig halten
practice makes perfect	Übung macht den Meister.
brownie points	Anerkennung|Lob|Belohnung|Bonus|Pluspunkt
a can of worms	eine Büchse der Pandora|ein Fass ohne Boden|ein Problemhaufen|ein Schlamassel
deer caught in headlights	wie das Kaninchen vor der Schlange stehen|wie gelähmt sein|wie erstarrt sein|wie angewurzelt stehen|wie vom Blitz getroffen sein
more harm than good	mehr Schaden als Nutzen
the bag	"figurative translation of ""the bag"" in this context is: the responsibility or the blame"
a stiff upper lip	eine steife Oberlippe bewahren|sich nichts anmerken lassen|tapfer bleiben|sich zusammenreißen
blew her top	aus der Haut fahren|die Beherrschung verlieren|sich aufregen|wütend werden
to tighten our belts	den Gürtel enger schnallen|sparsamer leben|weniger Geld ausgeben|sich einschränken
to stay above water	über Wasser bleiben|sich über Wasser halten|nicht untergehen|nicht ertrinken|nicht unter Stress zusammenbrechen
finger-licking good	köstlich|lecker|zum Reinlegen|zum Anbeißen|zum Fingerlecken
to face the music	die Konsequenzen akzeptieren|für etwas geradestehen|sich seiner Verantwortung stellen|die Wahrheit akzeptieren
to fit a square peg into a round hole	etwas erzwingen, was nicht passt|etwas erzwingen, was nicht funktioniert|etwas erzwingen, was nicht geeignet ist|etwas erzwingen, was nicht angemessen ist
be a breath of fresh air	eine willkommene Abwechslung sein|frischen Wind bringen|eine Bereicherung sein
get back on the horse	wieder anfangen|wieder einsteigen|wieder beginnen|sich erholen und weitermachen|sich wieder aufraffen|sich wieder motivieren
to be ahead of the curve	einen Schritt voraus sein|eine Nasenlänge voraus sein|sich im Voraus informieren|sich frühzeitig auf etwas einstellen
to bark up the wrong tree	etwas in die falsche Richtung versuchen|sich auf dem Holzweg befinden|einen Irrweg einschlagen|einen Fehler machen|eine falsche Fährte verfolgen
made the cut	erfolgreich sein|die Anforderungen erfüllen|die Voraussetzungen erfüllen|die Hürde nehmen|die Prüfung bestehen
to bring home the bacon	etwas erreichen, das Geld oder Erfolg bringt|den Kuchen backen und ihn auch essen können|Erfolg haben|Geld verdienen
To make a long story short	um es kurz zu machen|um es kurz zu sagen|kurz gesagt|zusammenfassend
lean on	sich auf jemanden verlassen|sich auf jemanden stützen|sich auf jemanden verlassen können|jemandem vertrauen können
rock the boat	etwas riskieren|etwas wagen|etwas in Gefahr bringen|etwas gefährden|etwas aufs Spiel setzen
shoulder to cry on	jemand, bei dem man sich ausweinen kann|jemand, der einem Trost spendet|jemand, der einem zuhört und unterstützt
kill them with kindness	jemanden mit Freundlichkeit überschütten|jemanden mit Freundlichkeit überraschen|jemanden mit Freundlichkeit überwältigen
at a low ebb	auf einem Tiefpunkt|in einer schlechten Verfassung|niedergeschlagen|demoralisiert
on the ball	auf Zack|auf Draht|aufmerksam|konzentriert|wachsam|auf dem Posten|auf dem Laufenden|auf Trab
pull it off	etwas erfolgreich durchziehen|etwas erfolgreich bewältigen|etwas erfolgreich abschließen|etwas erfolgreich meistern
perseverance pays off	Durchhaltevermögen zahlt sich aus|Beharrlichkeit führt zum Erfolg|Ausdauer wird belohnt
land on his feet	sich auf die Füße stellen|sich wieder erholen|sich wieder aufrappeln|wieder auf die Beine kommen
take your eye off the ball	sich ablenken lassen|sich ablenken lassen von wichtigen Dingen|sich ablenken lassen von den Zielen|sich ablenken lassen von den Prioritäten
cutting the mustard	to perform well|to meet expectations|to do a good job|to succeed
feel the burn	erschöpft sein|überarbeitet sein|sich ausgebrannt fühlen|sich erschöpft fühlen
grin from ear to ear	strahlen vor Glück|vor Freude grinsen|ein breites Grinsen im Gesicht haben|über beide Ohren grinsen
cup of tea	etwas, das man sehr mag|etwas, das einem sehr liegt|etwas, das einem sehr zusagt|etwas, das einem sehr gefällt
pat on the back	Anerkennung zeigen|jemanden loben|jemanden ermutigen|jemanden aufmuntern
peaches and cream	alles ist in Ordnung|alles ist perfekt|alles ist wunderbar|alles ist rosig
on edge	nervous|anxious|tense|apprehensive|worried|edgy
pinch of salt	Prise Salz|kleine Menge Salz|etwas Salz|eine Prise Würze
close to his chest	geheim halten|nicht verraten|nicht preisgeben|für sich behalten
cutting it too thin	knapp bemessen|auf Messers Schneide sein|zu spät dran sein|in Zeitnot sein
midnight oil	bis spät in die Nacht arbeiten|die Nacht durchmachen|lange arbeiten|lange wach bleiben, um zu arbeiten
guts and grit	Mut und Entschlossenheit|Mut und Durchhaltevermögen|Mut und Zähigkeit
moving full steam ahead	mit voller Kraft vorangehen|mit vollem Dampf voraus|schnell und erfolgreich expandieren
play both sides	mit beiden Seiten spielen|sich nicht festlegen|zwischen zwei Stühlen sitzen
stay put	an Ort und Stelle bleiben|bleiben wo man ist|nicht weggehen|nicht fortgehen|nicht weggehen
Biting the bullet	Sich zusammenreißen|Sich durchbeißen|Sich durchkämpfen|Sich durchsetzen|Sich durchschlagen|Sich behaupten|Sich etwas unangenehmes antun müssen
you can't have your cake and eat it too	Man kann nicht alles haben|Man kann nicht auf zwei Hochzeiten tanzen|Man kann nicht alles gleichzeitig haben
pulling my leg	jemanden auf den Arm nehmen|jemanden veräppeln|jemanden zum Narren halten
pulled the rug out from under me	plötzlich und unerwartet den Boden unter den Füßen verlieren|plötzlich und unerwartet aus der Bahn geworfen werden|plötzlich und unerwartet in eine schwierige Lage geraten
Barking up the wrong tree	Auf dem Holzweg sein|Sich im Irrtum befinden|Sich in der Sackgasse befinden
budge an inch	keinen Millimeter nachgeben|sich keinen Zentimeter bewegen|standhaft bleiben|unbeirrbar sein
running on fumes	am Ende sein|keine Energie mehr haben|ausgelaugt sein|erschöpft sein
off the wall	unangebracht|unpassend|abwegig|verrückt|schräg
raining on our parade	uns die Stimmung verderben|uns den Spaß verderben|uns die Laune verderben|uns den Tag vermiesen
playing with fire	mit dem Feuer spielen|ein hohes Risiko eingehen|sich auf dünnem Eis bewegen
hunker down	sich zusammenkauern|sich ducken|sich bereitmachen für etwas Schlimmes|sich auf etwas vorbereiten, das kommen wird
cross that bridge when I come to it	Das Problem wird sich schon lösen lassen, wenn es soweit ist|Ich werde das Problem angehen, wenn es soweit ist|Ich werde das Problem lösen, wenn es soweit ist
the good fight	der gute Kampf|der erfolgreiche Kampf|der Kampf für das Gute|der Kampf für eine gute Sache
take the plunge	sich ins kalte Wasser wagen|den Sprung ins Ungewisse wagen|etwas riskieren|etwas Neues ausprobieren
the blues	Depression|Traurigkeit|Niedergeschlagenheit|Melancholie
turn things around	die Dinge umdrehen|die Dinge wenden|die Dinge zum Besseren wenden|eine Wende schaffen|eine Trendwende schaffen
be there for her	für sie da sein|sie unterstützen|sie begleiten|sie trösten
sweep them under the rug	etwas unter den Teppich kehren|etwas verdrängen|etwas ignorieren|etwas verschweigen
cooking the books	die Bücher frisieren|die Bücher manipulieren|die Bilanzen fälschen|die Zahlen schönen
broke the ice	das Eis brechen|die Stimmung auflockern|den Anfang machen|den ersten Schritt machen|das Schweigen brechen
the real deal	echt|authentisch|original|wirklich gut|von hoher Qualität
take a load off	sich entspannen|sich ausruhen|sich erholen|sich eine Pause gönnen
a bunch of baloney	Unsinn|Quatsch|Blödsinn|Schwachsinn|Lüge
thin ice	auf dünnem Eis sein|sich in einer heiklen Lage befinden|sich auf unsicherem Terrain bewegen
batting an eye	ohne mit der Wimper zu zucken|ohne zu zögern|ohne zu überlegen
chickens out	sich drücken|sich vor etwas drücken|sich herausreden|sich feige verhalten|sich zurückziehen
burn bridges	alle Brücken hinter sich abbrechen|sich verbrennen|sich verbrannte Erde hinterlassen|sich von allem und jedem abwenden
keep our ducks in a row	alles im Griff haben|alles unter Kontrolle haben|gut organisiert sein|gut vorbereitet sein
behind closed doors	hinter verschlossenen Türen|im Verborgenen|heimlich|geheimnisvoll|im Geheimen
pull the wool over my eyes	jemanden hinters Licht führen|jemanden täuschen|jemanden betrügen
throwing money down the drain	Geld zum Fenster rauswerfen|Geld verschwenden|Geld verprassen|Geld vergeuden
come back to bite him	sich rächen|sich negativ auswirken|sich als Fehler erweisen|sich als Bumerang erweisen
apple pie	something that is very common or popular
cabin fever	Gefühl von Isolation und Langeweile durch zu viel Zeit in einem begrenzten Raum oder einer begrenzten Umgebung.
put all our eggs in one basket	alles auf eine Karte setzen|alles auf ein Pferd setzen|alles auf eine Option setzen
have a bee in his bonnet	sich über etwas aufregen|sich über etwas ärgern|sich über etwas beschweren|etwas ständig im Kopf haben
add up	sich schlüssig ergeben|sich zusammenfügen|sich reimen|sich decken|sich ergänzen
chasing her tail	sich im Kreis drehen|sich im Kreis bewegen|sich im Kreislauf befinden|sich im Hamsterrad befinden
beat a dead horse	etwas unnötig weiterverfolgen|auf etwas beharren, das bereits entschieden ist|einem toten Pferd hinterherlaufen
count your chickens before they hatch	den Tag vor dem Abend loben|sich zu früh freuen|sich zu früh sicher sein|vorzeitig jubeln
to kill two birds with one stone	zwei Fliegen mit einer Klappe schlagen
keep his eye on the ball	sich auf das Wesentliche konzentrieren|sich auf das Ziel fokussieren|sich aufmerksam zeigen|sich auf etwas konzentrieren|bei der Sache bleiben
cloud nine	auf Wolke sieben sein|überglücklich sein|sehr glücklich sein|im siebten Himmel sein
wrong tree	falsche Adresse|falscher Ansprechpartner|falscher Weg
read between the lines	zwischen den Zeilen lesen|die versteckte Bedeutung erkennen|das Unaussprechliche verstehen|das Offensichtliche ignorieren
monkey business	Unsinn|albernes Verhalten|Unfug|Unruhe|Unordnung
sting in the tail	unerwartete Wendung|unerwartetes Ende|unerwarteter Haken|unerwartete Pointe
landing on his feet	sich immer wieder auf die Beine stellen|sich immer wieder durchsetzen|sich immer wieder behaupten|sich immer wieder erholen
bee in her bonnet	etwas im Kopf haben, das man ständig anspricht|eine fixe Idee haben|etwas ständig im Kopf haben, das man nicht loswird
not the end of the world	kein Weltuntergang|nicht das Ende der Welt|nicht so schlimm|nicht dramatisch|nicht tragisch
social butterfly	geselliger Mensch|Kontaktfreudige Person|Gesellschaftslöwe|Gesellschaftsschmetterling
not his cup of tea	nicht sein Ding sein|nicht sein Fall sein|nicht sein Geschmack sein|nicht mögen
march to the beat of your own drum	Seinen eigenen Weg gehen|Sein eigenes Ding machen|Seine eigene Musik spielen|Seine eigene Melodie pfeifen
get her feet wet	sich einarbeiten|sich zurechtfinden|sich eingewöhnen|sich akklimatisieren
stop and smell the roses	sich Zeit nehmen|sich Zeit lassen|entspannen|die Dinge genießen|die Schönheit des Lebens wahrnehmen
step up their game	sich verbessern|sich steigern|sich anstrengen|sich mehr anstrengen|sich mehr bemühen|sich mehr engagieren|sich mehr Mühe geben|sich mehr ins Zeug legen|sich mehr anstrengen müssen|sich mehr anstrengen sollen|eine Schippe drauflegen|einen Zahn zulegen
take it easy	sich schonen|sich zurückhalten|sich ausruhen|es langsam angehen lassen
showed his true colors	seine wahren Absichten offenbaren|seine wahren Farben zeigen|seine Maske fallen lassen
bunch of hogwash	Unsinn|Schwachsinn|Quatsch|Blödsinn|Unfug
beauty contest	Konkurrenzkampf|Wettbewerb|Ausscheidungskampf|Herausforderung
the bee's knees	etwas Besonderes|etwas Außergewöhnliches|etwas Tolles|etwas Großartiges|etwas Hervorragendes
keep her head above water	sich über Wasser halten|sich über Wasser halten können|nicht untergehen|nicht untergehen können|nicht untergehen lassen|nicht untergehen lassen können
death warmed over	aussehen wie der Tod auf Urlaub|aussehen wie der Tod auf Latschen|furchtbar aussehen|furchtbar schlecht aussehen|NA
a big fish in a small pond	ein großer Fisch im kleinen Teich sein
can stomach	ertragen|aushalten|verkraften|dulden
sweating bullets	sehr nervös sein|sich in die Hose machen|sich in die Hosen machen|sich in die Hose scheißen|sich in die Hosen scheißen|sich in die Hose machen vor Angst|sich in die Hosen machen vor Furcht|sich in die Hose machen vor Schreck|sich in die Hosen machen vor Aufregung|sich in die Hose machen vor Nervosität|sich in die
a bee in her bonnet	etwas auf dem Kieker haben|etwas ständig im Kopf haben|etwas ständig im Sinn haben|etwas ständig im Blick haben
in over his head	überfordert sein|sich über den Kopf wachsen lassen|nicht mehr Herr der Lage sein|sich in Schwierigkeiten bringen
lend a hand	jemandem unter die Arme greifen|jemandem helfen|jemandem zur Hand gehen|jemandem unterstützen
in the bag	sicher sein|in trockenen Tüchern sein|bereits gewonnen haben|sicher sein, dass etwas passieren wird
has bees in his bonnet	besessen sein von etwas|etwas ständig im Kopf haben|etwas nicht aus dem Kopf bekommen
miss the boat	eine Chance verpassen|den Anschluss verlieren|zu spät kommen|den Zug verpassen
had bats in her belfry	verrückt sein|nicht mehr alle Tassen im Schrank haben|nicht mehr ganz bei Sinnen sein
rest on his laurels	sich auf seinen Lorbeeren ausruhen|sich auf seinen Erfolgen ausruhen|sich zurücklehnen und nichts tun
put all her eggs in one basket	To rely on one thing only|To depend on one thing only|To concentrate all efforts on one thing only
chip off the old block	jemandem wie aus dem Gesicht geschnitten sein|jemandem sehr ähnlich sein|wie der Vater, so der Sohn|wie die Mutter, so die Tochter
buried her head in the sand	sich vor der Realität verschließen|den Kopf in den Sand stecken|die Augen vor der Wahrheit verschließen
touch base	Kontakt aufnehmen|sich melden|sich in Verbindung setzen|sich kurz absprechen
there's no tomorrow	als gäbe es kein Morgen|ohne Rücksicht auf Verluste|ohne an die Zukunft zu denken
at loggerheads	sich in den Haaren liegen|sich streiten|sich zanken|sich bekämpfen
the elephant in the room	something that is obvious but not talked about|ein offenes Geheimnis|ein unangenehmes Thema, das vermieden wird|ein Tabuthema
put their best foot forward	sich von der besten Seite zeigen|sich von der Schokoladenseite präsentieren|einen guten Eindruck machen wollen
keep his cool	Ruhe bewahren|die Nerven behalten|gelassen bleiben|sich nicht aus der Ruhe bringen lassen
put her foot in her mouth	etwas Falsches sagen|ins Fettnäpfchen treten|sich ungeschickt ausdrücken|einen Fauxpas begehen
hold your horses	etwas langsamer angehen|sich etwas gedulden|sich zurückhalten|nicht voreilig handeln
stealing the show	die Show stehlen|im Rampenlicht stehen|im Mittelpunkt stehen|die Aufmerksamkeit auf sich ziehen
wears his heart on his sleeve	seine Gefühle offen zeigen|seine Emotionen nicht verbergen|seine Gefühle nicht verstecken|offen seine Meinung sagen
to mind her own beeswax	to mind her own business|to stop being so curious|to stop being nosy|to stop meddling in other people's affairs
cracked the whip	streng durchgreifen|eine harte Linie fahren|eine harte Hand haben|disziplinieren
to keep her head above water	sich über Wasser halten|sich über Wasser halten können|nicht untergehen|nicht untergehen können|nicht aufgeben|durchhalten|durchstehen
skeletons in the closet	Geheimnisse|Dinge, die man lieber versteckt halten möchte|unangenehme Wahrheiten|peinliche Details aus der Vergangenheit
the skin of his teeth	gerade noch|mit Ach und Krach|knapp und gerade so|in letzter Sekunde|in letzter Minute
not to take things personally	etwas nicht persönlich nehmen|sich nicht angegriffen fühlen|sich nicht beleidigt fühlen|sich nicht verletzt fühlen
Biting off more than you can chew	Sich übernehmen|Sich zu viel vornehmen|Sich überfordern|Sich zu viel zumuten
put his two cents in	sich einmischen|seinen Senf dazugeben|seine Meinung kundtun|sich einmischen, obwohl man nichts dazu beitragen kann
keep an eye out	aufeinander aufpassen|für die Sicherheit des anderen sorgen|für einander da sein|für einander einstehen
shooting for the moon	sich hohe Ziele setzen|nach den Sternen greifen|sich nicht mit weniger zufriedengeben|große Ambitionen haben
changes horses midstream	das Pferd wechseln|den Kurs ändern|die Meinung ändern|eine neue Richtung einschlagen
thrown for a loop	völlig überrascht sein|völlig aus der Bahn geworfen werden|völlig perplex sein|völlig verwirrt sein
jump through hoops	sich durchkämpfen|mühsam durchsetzen|sich anstrengen, um etwas zu erreichen|sich anstrengen, um etwas zu schaffen
letting her hair down	sich gehen lassen|sich entspannen|sich locker machen|sich amüsieren
lose sleep over something	sich Sorgen machen|nicht schlafen können wegen etwas|etwas beschäftigt einen sehr
get his ducks in a row	Ordnung schaffen|sich organisieren|sich vorbereiten|sich vorbereiten, um erfolgreich zu sein
hit it out of the park	etwas mit Bravour meistern|etwas hervorragend machen|eine großartige Leistung erbringen
manage her time better	ihre Zeit besser einteilen|ihre Zeit besser managen|ihre Zeit besser verwalten|ihre Zeit besser organisieren
fishy going on	etwas faul sein|etwas nicht stimmen|etwas verdächtig sein|etwas seltsam sein
reap what he sows	ernten, was er gesät hat|die Früchte seiner Arbeit ernten|für seine Arbeit belohnt werden
going around in circles	keine Fortschritte machen|sich im Kreis drehen|nicht vorankommen|keine Lösung finden
stick with it	dabei bleiben|durchhalten|nicht aufgeben|am Ball bleiben
on top of the world	sich wie im siebten Himmel fühlen|überglücklich sein|auf Wolke sieben schweben
let his hair down	sich entspannen|sich gehen lassen|sich amüsieren|sich vergnügen|locker werden
keep your eye on the ball	sich auf das Wesentliche konzentrieren|den Fokus behalten|sich auf das Ziel konzentrieren|sich auf das Wichtigste konzentrieren
fair shake	gerechte Chance|faire Gelegenheit|gleiche Möglichkeiten|gleiche Chancen
steals the show	die Show stehlen|im Mittelpunkt stehen|die Aufmerksamkeit auf sich ziehen|sich in den Vordergrund drängen
get them straightened out	Ordnung schaffen|in Ordnung bringen|wieder in Ordnung bringen|wiederherstellen|korrigieren|bereinigen
the best thing since sliced bread	etwas ist das Beste seit es etwas gibt|etwas ist das Größte seit es etwas gibt|etwas ist das Tollste seit es etwas gibt
burning the candle at both ends	sich überarbeiten|sich verausgaben|sich zu viel zumuten|sich zu viel abverlangen
carved out a successful career	sich eine erfolgreiche Karriere aufbauen|sich eine erfolgreiche Karriere erarbeiten|eine erfolgreiche Karriere schaffen
the ball	die Sache|die Aufgabe|die Verantwortung|das Projekt
made it big	es geschafft haben|groß rauskommen|groß rausgekommen sein|erfolgreich sein|erfolgreich geworden sein
dance to your own tune	sich nicht von anderen beeinflussen lassen|sein eigenes Ding machen|seinen eigenen Weg gehen|sich nicht von anderen vorschreiben lassen, was man tun soll
to keep your eye on the ball	sich auf das Wesentliche konzentrieren|den Fokus behalten|sich auf das Ziel konzentrieren|sich auf das Wichtigste konzentrieren
let her hair down	sich entspannen|sich gehen lassen|sich locker machen|sich amüsieren|sich vergnügen
keeping her in the dark	jemanden im Dunkeln lassen|jemanden im Unklaren lassen|jemanden im Ungewissen lassen
in a pickle	in der Klemme|in Schwierigkeiten|in einer Zwickmühle|in Verlegenheit|in einer misslichen Lage
throwing in the towel	aufgeben|das Handtuch werfen|sich geschlagen geben|kapitulieren
on the wrong side of the bed	mit dem falschen Fuß aufstehen
the brass ring	NA
test the waters	ausprobieren|testen|herantasten|sich vorsichtig annähern
six of one and half a dozen of the other	beides ist gleich|sechs von einem, halbes Dutzend vom anderen|kein Unterschied
seeing red	wütend sein|vor Wut kochen|rot sehen|außer sich sein|sich grün und blau ärgern
blow their socks off	jemanden beeindrucken|jemanden umhauen|jemanden begeistern|jemanden überzeugen
to let off steam	Dampf ablassen|sich abreagieren|sich Luft machen|sich entspannen
a shot in the dark	ein Schuss ins Blaue|ein Versuch ins Ungewisse|ein Sprung ins kalte Wasser
the green light	die Zustimmung|das Okay|das Go|das Startsignal|die Freigabe
hot water	Schwierigkeiten|Probleme|Ärger|Konflikt|Missgeschick
to see stars	Sterne sehen|Sternchen sehen|vor Augen haben|schwarz vor Augen werden|schwindelig werden
woke up on the wrong side of the bed	mit dem falschen Fuß aufgestanden sein|mit dem falschen Bein zuerst aufgestanden sein|schlecht gelaunt aufgewacht sein
rain check	verschieben|aufschieben|einen neuen Termin vereinbaren|ein andermal machen
blow his own trumpet	sich selbst loben|sich selbst beweihräuchern|sich selbst bewundern|sich selbst in den Himmel heben
shaken like a leaf	zittern wie Espenlaub|vor Angst zittern|vor Aufregung zittern
a tough cookie	eine harte Nuss|eine Herausforderung|schwierig zu bewältigen|schwierig zu meistern
black ice	NA
in her element	in ihrem Element sein|sich in ihrem Element befinden|sich in ihrem Element fühlen|in ihrem Element aufgehen
on pins and needles	auf heißen Kohlen sitzen|gespannt sein|nervös sein|unruhig sein
a rock and a hard place	zwischen zwei Stühlen sitzen|in der Zwickmühle sein|vor der Wahl stehen|vor einem Dilemma stehen
old hat	nicht mehr aktuell|nicht mehr interessant|ausgelutscht|abgedroschen|nicht mehr neu
hit the road	sich auf den Weg machen|losfahren|abfahren|aufbrechen|weggehen|sich verabschieden
a few tricks up their sleeve	ein paar Asse im Ärmel haben|ein paar Überraschungen bereithalten|noch etwas Besonderes bieten
to rock the boat	etwas riskieren|Unruhe stiften|für Aufregung sorgen|für Unruhe sorgen|für Ärger sorgen|für Probleme sorgen
to hit the sack	ins Bett gehen|sich schlafen legen|zu Bett gehen|sich zur Ruhe setzen
to follow one's heart	seinem Herzen folgen|seiner Leidenschaft folgen|seinen Träumen folgen|seinen Wünschen folgen
to get the ball rolling	etwas ins Rollen bringen|den Anfang machen|den Stein ins Rollen bringen|den Startschuss geben
to turn the corner	eine Wende schaffen|über den Berg sein|eine Besserung erreichen|eine Verbesserung erreichen
to see the light at the end of the tunnel	das Ende des Tunnels sehen|das Ziel erreichen|das Projekt abschließen|das Ende in Sicht haben
fishing in troubled waters	sich auf unsicheres Terrain begeben|sich in gefährliches Gewässer begeben|sich auf dünnem Eis bewegen
to take the bull by the horns	etwas entschlossen angehen|etwas mutig angehen|etwas energisch angehen|etwas beherzt angehen
out of this world	außergewöhnlich|herausragend|unglaublich gut|fantastisch|überragend
cracked a smile	ein Lächeln zeigen|lachen|grinsen|sich amüsieren|sich köstlich amüsieren
on the same page	auf derselben Wellenlänge sein|einig sein|gleiche Vorstellungen haben|einheitlich handeln
let you off the hook	verzeihen|durchgehen lassen|nicht bestrafen|nicht zur Rechenschaft ziehen
silly goose	alberner Gans|alberne Gans|albernes Huhn|alberner Vogel
turning the tables	das Blatt wenden|die Rollen umkehren|sich rächen|sich revanchieren
cross that bridge when we come to it	Das Problem aufschieben|Das Problem später lösen|Erstmal abwarten und dann entscheiden|Erstmal schauen, was passiert
hit it off	sich gut verstehen|sich auf Anhieb gut verstehen|sich auf Anhieb sympathisch sein|sich auf Anhieb mögen
blow off some steam	Dampf ablassen|sich abreagieren|sich entspannen|sich erholen
living in a dream world	in einer Traumwelt leben|in den Wolken schweben|nicht in der Realität leben
green behind the ears	unerfahren|unbedarft|noch nicht lange dabei|noch nicht viel Erfahrung haben
all thumbs	ungeschickt sein|tollpatschig sein|zwei linke Hände haben
bag of rags	unordentlich|ungepflegt|schlampig|verlottert
loose ends	offene Enden|ungeklärte Fragen|unvollständige Details|unbeantwortete Fragen
around the block	er hat schon einiges erlebt|er ist schon lange dabei|er hat schon viel Erfahrung gesammelt
more than I can chew	mehr, als ich bewältigen kann|zu viel auf einmal wollen|sich übernehmen|sich überfordern
paying off	sich auszahlen|erfolgreich sein|Früchte tragen|sich lohnen
blew my mind	hat mich umgehauen|hat mich beeindruckt|hat mich überzeugt|hat mich sprachlos gemacht
see eye-to-eye	sich auf Augenhöhe begegnen|sich einig sein|eine gemeinsame Basis finden
big cheese	wichtige Person|großer Fisch|einflussreiche Person|bedeutende Persönlichkeit
a tempest in a teapot	a storm in a teacup|much ado about nothing|making a mountain out of a molehill
make time	sich Zeit nehmen|Zeit freimachen|Zeit einräumen|Zeit opfern
count our chickens before they hatch	den Tag nicht vor dem Abend loben|nicht voreilig sein|nicht zu früh freuen|nicht zu früh jubeln
water under the bridge	vergessen und vergeben|Schnee von gestern|abgehakt|überwunden|vergangene Dinge, die keine Rolle mehr spielen
throws a curveball	eine unerwartete Schwierigkeit aufwerfen|eine unerwartete Herausforderung stellen|eine unerwartete Wendung nehmen
just what the doctor ordered	genau das Richtige|genau das, was sie braucht|eine Wohltat|eine Erleichterung
too little too late	zu wenig und zu spät|zu spät und zu wenig|nicht ausreichend und verspätet|NA
put all my eggs in one basket	alles auf ein Pferd setzen|alles auf eine Karte setzen
rubbing salt in my wounds	Salz in die Wunde streuen|Salz in die Wunden reiben|jemandem noch mehr wehtun|jemandem noch mehr verletzen
fly by the seat of his pants	etwas aus dem Bauch heraus entscheiden|etwas spontan entscheiden|etwas aus dem Stehgreif machen|etwas aus dem Moment heraus entscheiden
get lost	verschwinde|verzieh dich|zieh Leine|geh weg|verpiss dich
knowledge is power	Wissen ist Macht.
meet halfway	sich auf halbem Weg treffen|einen Kompromiss finden|sich einigen|auf einen Nenner kommen
keeping their eye on the ball	sich auf das Wesentliche konzentrieren|fokussiert bleiben|den Fokus nicht verlieren|sich auf das Ziel konzentrieren
paid through the nose	sehr viel bezahlen|überhöhte Preise zahlen|tief in die Tasche greifen|mehr bezahlen als notwendig
kick back and relax	sich zurücklehnen und entspannen|sich ausruhen und entspannen|sich zurücklehnen und die Seele baumeln lassen
keep their noses to the grindstone	sich ins Zeug legen|sich an die Arbeit machen|sich konzentrieren|sich anstrengen|hart arbeiten
get your ducks in a row	alles vorbereiten|alles organisieren|alles planen|alles in Ordnung bringen|alles auf die Reihe bekommen
be at each other's throats	ständig streiten|sich ständig in den Haaren liegen|sich ständig zanken|sich ständig kabbeln
stand their ground	auf seinem Standpunkt beharren|seine Meinung verteidigen|sich nicht beugen|nicht nachgeben|sich durchsetzen wollen
couldn't see the forest for the trees	sich im Detail verlieren|den Wald vor lauter Bäumen nicht sehen|sich in Kleinigkeiten verlieren|den Überblick verlieren
Time flies	Die Zeit vergeht wie im Flug.
burst a blood vessel	vor Wut platzen|vor Wut kochen|vor Wut explodieren|vor Wut fast platzen
get down to brass tacks	zur Sache kommen|zum Wesentlichen kommen|zur Kernfrage übergehen|zur Hauptsache kommen
the wrong side of the bed	mit dem falschen Fuß aufstehen
picks up the tab	die Rechnung übernehmen|für etwas aufkommen|bezahlen
knocked it out of the park	eine großartige Leistung erbringen|einen Volltreffer landen|einen grandiosen Erfolg erzielen
keep his head above water	sich über Wasser halten|sich über Wasser halten können|sich über Wasser halten in schwierigen Zeiten
has a chip on her shoulder	sich schnell angegriffen fühlen|schnell beleidigt sein|schnell gereizt sein|eine beleidigte Leberwurst sein
knows the ropes	sich auskennen|mit etwas vertraut sein|die Abläufe kennen|die Regeln kennen
set in their ways	festgefahren|eingefahren|stur|unbelehrbar|unflexibel
bit my tongue	sich zurückhalten|sich beherrschen|sich zusammenreißen|nichts sagen|nichts erwidern
find his feet	sich zurechtfinden|sich etablieren|Fuß fassen|sich einleben|sich akklimatisieren
in one ear and out the other	Das geht zum einen Ohr rein und zum anderen wieder raus.
back to square one	wieder am Anfang sein|wieder bei Null anfangen|wieder von vorne beginnen|wieder von vorn anfangen
come true	in Erfüllung gehen|wahr werden|sich erfüllen
beats around the bush	um den heißen Brei herumreden|ausweichend antworten|nicht konkret werden|sich nicht festlegen wollen
a flash in the pan	Something that initially shows great promise but quickly fails or disappoints.
hit the hay early	früh ins Bett gehen|früh schlafen gehen|sich früh zur Ruhe setzen
lost her marbles	verrückt werden|den Verstand verlieren|durcheinander geraten|verwirrt sein
wild card	Unberechenbarer Faktor|Unsicherheitsfaktor|Wundertüte|Überraschungspaket
a little birdie told me	Ich habe aus sicherer Quelle erfahren|Ich habe von jemandem gehört|Ich habe es durch die Blume erfahren
getting our ducks in a row	unsere Angelegenheiten in Ordnung bringen|unsere Angelegenheiten ordnen|unsere Angelegenheiten aufeinander abstimmen|unsere Angelegenheiten koordinieren
to count his chickens before they hatch	den Tag vor dem Abend loben|sich zu früh freuen|sich zu früh sicher sein|vorzeitig jubeln
to grin and bear it	sich zusammenreißen|sich beherrschen|durchhalten|durchbeißen|tapfer sein
control freak	Kontrollfreak|Kontrollwahn|Kontrollzwang|Kontrollsucht
took a rain check	verschieben|auf später verschieben|einen neuen Termin vereinbaren|ein andermal machen
live wire	energetic and lively person|someone who is full of energy and enthusiasm
chill out	entspannen|sich ausruhen|sich erholen|sich zurücklehnen|abschalten
off her chest	etwas loswerden|etwas von der Seele reden|sich etwas von der Seele reden|sich etwas von der Seele schreiben
down for the count	k.o. gehen|am Boden liegen|niederliegen|nicht mehr handlungsfähig sein|nicht mehr weitermachen können
light at the end of the tunnel	Hoffnungsschimmer|Lichtblick|positive Aussicht|positive Perspektive
to open a can of worms	ein heikles Thema ansprechen|eine heikle Angelegenheit aufmachen|eine Diskussion beginnen, die zu Problemen führen könnte
make hay while the sun shines	die Gunst der Stunde nutzen|eine günstige Gelegenheit nutzen|eine Chance ergreifen, solange sie da ist
find a needle in a haystack	etwas sehr Schwieriges oder Unmögliches finden|etwas sehr Kleines oder Verstecktes finden, das schwer zu finden ist
not even a crumb	nicht einmal einen Krümel|nichts übrig lassen|alles aufessen|nichts zurücklassen
hit the sack	ins Bett gehen|sich schlafen legen|sich zur Ruhe setzen|sich ausruhen
butterflies in your stomach	ein mulmiges Gefühl im Bauch haben|sich unwohl fühlen|nervös sein|Herzklopfen haben
to put on a brave face	eine tapfere Miene aufsetzen|sich nichts anmerken lassen|sich zusammenreißen|sich beherrschen
to pull out all the stops	alle Register ziehen|alle Hebel in Bewegung setzen|alles tun, was in der Macht steht|sich ins Zeug legen|sich voll reinhängen
a dish that steals the show	ein Gericht, das alle Blicke auf sich zieht|ein Gericht, das alle anderen Gerichte in den Schatten stellt|ein Gericht, das alle anderen Gerichte übertrifft
fail by a country mile	sang- und klanglos durchfallen|kläglich scheitern|weit entfernt von Erfolg sein
to shoot your shot	sein Glück versuchen|es probieren|eine Chance wagen|sein Schicksal herausfordern
to keep his head above water	sich über Wasser halten|nicht untergehen|nicht aufgeben|durchhalten|durchstehen
to prove them all wrong	jemandem das Gegenteil beweisen|alle Zweifel ausräumen|jemandem das Gegenteil zeigen|jemandem das Gegenteil demonstrieren
tie the knot	sich trauen|heiraten|den Bund fürs Leben schließen|vor den Traualtar treten
take it with a grain of salt	etwas nicht allzu ernst nehmen|etwas skeptisch betrachten|etwas mit Vorsicht genießen
pull someone's leg	jemanden auf den Arm nehmen|jemanden veräppeln|jemanden zum Narren halten
skip a beat	schneller schlagen|aussetzen|rasen|schneller schlagen lassen|schneller schlagen hören
to put my best foot forward	sich von der besten Seite zeigen|sich von der Schokoladenseite präsentieren|sich von der besten Seite präsentieren|sein Bestes geben|sein Bestes zeigen
keep his nose to the grindstone	sich auf die Arbeit konzentrieren|sich auf die Arbeit stürzen|sich auf die Arbeit fokussieren|sich auf die Arbeit konzentrieren|sich auf die Arbeit besinnen|sich auf die Arbeit konzentrieren|sich auf die Arbeit konzentrieren|sich auf die Arbeit konzentrieren|sich auf die Arbeit konzentrieren|sich auf die Arbeit konzentrieren|sich auf
get back on her feet	sich wieder aufrappeln|wieder auf die Beine kommen|sich erholen|sich wieder fangen
