Alex	Alex
Sophie	Sophie
David	David
Caroline	Caroline
John	John
Julia	Julia
Lucas	Lucas
Oliver	Oliver
Maria	Maria
Paul	Paul
Carla	Carla
Max	Max
Elena	Elena
Olivia	Olivia
George	George
Maggie	Maggie
William	William
Sophia	Sophia
Jackson	Jackson
Jessica	Jessica
James	James
Liam	Liam
Ava	Ava
Emily	Emily
Lola	Lola
Natalie	Natalie
Adam	Adam
Nicole	Nicole
Carlos	Carlos
Giovanni	Giovanni
Eleanor	Eleanor
Isabella	Isabella
Sarah	Sarah
Cameron	Cameron
Jason	Jason
Anthony	Anthony
Nina	Nina
Michael	Michael
Taylor	Taylor
Julie	Julie
Thomas	Thomas
Lisa	Lisa
Nate	Nate
Rachel	Rachel
Anna	Anna
Jack	Jack
Dwayne	Dwayne
Karen	Karen
Samantha	Samantha
Daniel	Daniel
Scarlett	Scarlett
Jonathan	Jonathan
Mia	Mia
Julian	Julian
Jacob	Jacob
Alicia	Alicia
Gabriela	Gabriela
Helen	Helen
Chris	Chris
Kate	Kate
Alexandre	Alexandre
Ethan	Ethan
Jennifer	Jennifer
Audrey	Audrey
Tyler	Tyler
Rebecca	Rebecca
Ana	Ana
Megan	Megan
Antonio	Antonio
Isaac	Isaac
Leo	Leo
Justin	Justin
Michelle	Michelle
Nora	Nora
Rita	Rita
Hannah	Hannah
Maxwell	Maxwell
Lupita	Lupita
Naomi	Naomi
Tony	Tony
Juan	Juan
Diego	Diego
Jasmine	Jasmine
Vivian	Vivian
Mario	Mario
Tara	Tara
Lionel	Lionel
Chloe	Chloe
Gabriel	Gabriel
Abby	Abby
Nathan	Nathan
Susan	Susan
Ella	Ella
Jake	Jake
Avery	Avery
Mike	Mike
Beyoncé	Beyoncé
Charlie	Charlie
Andrew	Andrew
Ben	Ben
Elon	Elon
Ariana Grande	Ariana Grande
Tom Hanks	Tom Hanks
Pedro	Pedro
Catherine	Catherine
Miguel	Miguel
Benjamin	Benjamin
Isabelle	Isabelle
Sandra	Sandra
Joshua	Joshua
Samuel	Samuel
Steve	Steve
Lily	Lily
Tom	Tom
Eva	Eva
Ariana	Ariana
Eric	Eric
Ryan	Ryan
Amanda	Amanda
Victoria	Victoria
Lena	Lena
Victor	Victor
Robert	Robert
Lila	Lila
Mickey Mouse	Mickey Mouse
Linda	Linda
Steven	Steven
Michael Jackson	Michael Jackson
Spider-Man	Spider-Man
Carlos Santana	Carlos Santana
Kevin	Kevin
Jenna	Jenna
Tom Hardy	Tom Hardy
Grace	Grace
Batman	Batman
Stephen Hawking	Stephen Hawking
Ed Sheeran	Ed Sheeran
Taylor Swift	Taylor Swift
Nick	Nick
Riccardo	Riccardo
Amelia	Amelia
Freddie Mercury	Freddie Mercury
Leonardo da Vinci	Leonardo da Vinci
Jenny	Jenny
Alexandra	Alexandra
Jane	Jane
Melissa	Melissa
Gabriel Garcia Marquez	Gabriel Garcia Marquez
Google	Google
Robert De Niro	Robert De Niro
Victoria Beckham	Victoria Beckham
Henry	Henry
Mr. Johnson	Mr. Johnson
Whitney Houston	Whitney Houston
Miami	Miami
Elisa	Elisa
Oscar	Oscar
Annie	Annie
Evelyn	Evelyn
Stephen	Stephen
Lucy	Lucy
Diana	Diana
Gina	Gina
Luke	Luke
Nancy	Nancy
Josh	Josh
IBM	IBM
Marcus	Marcus
Van Gogh	Van Gogh
Idris Elba	Idris Elba
Brian	Brian
Joseph	Joseph
Juliana	Juliana
Paula	Paula
Kelly	Kelly
Kim	Kim
Buddy	Buddy
Lauren	Lauren
Denzel	Denzel
Sara	Sara
