down in the dumps	deprimido | triste
keeping all balls in the air	mantener muchas cosas en orden o bajo control al mismo tiempo
knocks it out of the park	tener un gran éxito
put all your eggs in one basket	arriesgarlo todo en una sola cosa
think outside the box	pensar de manera creativa o innovadora | pensar fuera de lo convencional
calls a spade a spade	hablar con franqueza, decir las cosas como son
dead tired	muertos de cansancio | agotados
fell apart	colapsó emocionalmente
pass with flying colors	aprobar con excelencia
under the weather	sentirse mal o enfermo
get a word in edgewise	No puedo meter baza cuando mi jefe está hablando.
spills the beans	revelar un secreto antes de tiempo | contar un secreto sin querer
face the music	enfrentar las consecuencias de sus acciones
over the moon	muy emocionada/feliz
to pull it off	lograrlo con éxito | conseguirlo
keep their eyes on the ball	mantenerse concentrados en lo que están haciendo
speaks with a forked tongue	hablar con doble intención|hablar con hipocresía
bite the bullet	hacer algo difícil o desagradable que se ha estado evitando
on it like a crutch	en ella como si fuera un bastón
take everything he says with a grain of salt	No tomar todo lo que dice al pie de la letra|No creer todo lo que dice sin cuestionarlo
out of left field	inesperado|sorprendente|fuera de lo común
sink or swim	tener que arriesgarse y hacerlo sin ayuda o fracasar
sour grapes	despecho por no haber conseguido algo|envidia disimulada por no haber conseguido algo
wait and see	esperar para ver|veremos qué pasa
silver bullet	solución mágica|solución perfecta
cut the mustard	hacer el trabajo bien|ser lo suficientemente bueno para hacer algo
a catch	una persona valiosa o interesante
beat around the bush	andarse con rodeos|ir al grano
like a fish out of water	sentirse fuera de lugar|sentirse incómodo en una situación nueva o desconocida
burn the candle at both ends	trabajar mucho y dormir poco|vivir al límite
chew the fat	charlar|platicar|hablar sin prisa
bury the hatchet	intentar hacer las paces|intentar reconciliarse
bark up the wrong tree	equivocarse de objetivo|dirigirse a la persona equivocada
pick myself up by my bootstraps	levantarme por mi cuenta|recuperar mi ánimo por mi cuenta
pie in the sky	algo que suena demasiado bueno para ser verdad|una promesa poco realista
Pandora's box	un problema muy grande que desencadena otros problemas
to play it by ear	improvisar|decidir sobre la marcha|tomar una decisión en el momento
through the wringer	someter a alguien a una prueba difícil o exigente|poner a alguien a prueba de manera rigurosa
you have to break a few eggs to make an omelette	Para lograr algo nuevo, a veces es necesario cometer errores o sacrificar algo.
a big softie	una persona muy sensible
drop the ball	cometer un error grave|fracasar en algo importante
to play second fiddle	to be in a subordinate position|to have a less important role
not my cup of tea	no es lo mío|no es lo mío, no es lo que me gusta o se me da bien
to bite the bullet	hacer algo difícil o desagradable que se debe hacer sin dudarlo o vacilar
the ball rolling	empezar a hacer algo|iniciar algo
a piece of cake	muy fácil|pan comido
his word	su palabra
her cool	su calma|la compostura
plan A	el primer plan|el plan principal|el plan inicial
making a mountain out of a molehill	exagerar un problema pequeño o insignificante
skeletons in his closet	secretos oscuros del pasado que no quiere que nadie sepa
hit the nail on the head	lograr algo con éxito|dar en el clavo
bigger fish to fry	cosas más importantes que hacer|asuntos más urgentes que atender
it takes two to tango	Una situación conflictiva o un problema no se produce por la acción de una sola persona, sino por la acción de dos o más personas.
hit the hay	irse a dormir | acostarse
bats in his belfry	locura|estar loco
hot under the collar	estar muy enojado
smoke and mirrors	engaño|ilusión|apariencia engañosa
a chip on his shoulder	tener una actitud hostil o resentida sin motivo aparente
the icing on the cake	algo que mejora una situación ya buena|algo adicional que hace que algo bueno sea aún mejor
a chip off the old block	una persona muy parecida a otra, especialmente a su padre o madre
break a leg	buena suerte|mucha suerte
tighten our belts	ajustar el cinturón|apretarnos el cinturón|reducir gastos
barking up the wrong tree	estar equivocado en la forma de abordar un problema o situación|estar en un camino equivocado para lograr algo
stick to her guns	mantenerse firme en su decisión o postura|no cambiar de opinión o decisión a pesar de la oposición o críticas de otros
his heart set on	estar decidido a hacer algo|tener la mente puesta en algo
an uphill battle	una tarea difícil y complicada que requiere mucho esfuerzo y dedicación.
in over her head	estar en problemas|estar en aprietos|estar en dificultades|estar en una situación que no se puede manejar
with words	con las palabras
circumstances beyond our control	circunstancias imprevistas fuera de nuestro control
her own business	su propio negocio
running around like a headless chicken	moverse como pollo sin cabeza
the show	el protagonismo|la atención de todos
food for thought	motivos para reflexionar|razones para pensar|argumentos para considerar
between you and me	entre nosotros|en confianza
take shape	empezar a tener forma|empezar a tomar forma
a litter of kittens	NA (This is not an idiomatic expression, it is a literal description of a situation.)
roll with the punches	adaptarse a los cambios y dificultades de la vida sin desanimarse
To let the cat out of the bag	revelar un secreto|descubrir algo que se quería mantener en secreto
between a rock and a hard place	estar entre la espada y la pared
knocking on wood	"NA (This expression is not an idiom, but a combination of two idiomatic expressions: ""her knees were knocking"" meaning she was trembling with fear or nervousness, and ""knocking on wood"" meaning to touch or knock on wood for good luck or to avoid tempting fate.)"
your chickens before they're hatched	contar con algo que aún no ha sucedido|dar algo por hecho antes de que suceda
nipped it in the bud	solucionamos el problema a tiempo|cortamos el problema de raíz
spilled milk	algo que ya pasó y no se puede cambiar|lo que ya está hecho y no se puede remediar
ins and outs	todos los detalles|todos los entresijos
pick up the ball and run with it	continuar con algo que se dejó pendiente sin problemas o dificultades.
put your best foot forward	hacer una buena impresión|dar lo mejor de uno mismo
Burning bridges	romper relaciones definitivamente|quemar las naves
beg, borrow or steal	hacer lo que sea necesario para conseguir algo, incluso si es ilegal o inmoral
let the chips fall where they may	aceptar las consecuencias|dejar que las cosas sucedan naturalmente|dejar que las cosas sigan su curso natural
walking the talk	cumplir lo que se dice|demostrar con acciones lo que se dice
break the ice	hacer el primer movimiento para iniciar una conversación o relación amistosa con alguien que no conoces o que está distante.
put our best foot forward	hacer lo mejor que podamos|dar lo mejor de nosotros mismos
play it by ear	improvisar|decidir sobre la marcha|adaptarse a las circunstancias
bee in his bonnet	obsesión por algo, idea fija
separating the wheat from the chaff	separar a los buenos de los malos|separar a los mejores de los peores|separar a los que saben de los que no saben|separar a los capaces de los incapaces
putting money aside for a rainy day	ahorrar para tiempos difíciles|ahorrar para el futuro|prepararse para lo peor
call it a day	terminar por hoy|dar por finalizado el trabajo del día
on cloud nine	muy feliz|en la cima del mundo
spice things up	darle sabor a las cosas|darle vida a las cosas|animar las cosas
at home	como en casa|cómodos y bienvenidos
seize the day	aprovechar el momento|aprovechar el día
nodding off	quedarse dormido sin querer|mecerse en los brazos de Morfeo
like a duck to water	adapted well and comfortably to the new situation
hit the books	ponerse a estudiar con dedicación y esfuerzo.
bounce back	recuperarse de un revés|superar un contratiempo
building castles in the air	soñar despierto|tener ilusiones sin fundamento
fighting chance	posibilidad de éxito a pesar de las dificultades
my back	mi espalda|mi apoyo
coming up roses	todo está saliendo bien|todo está yendo sobre ruedas
golden touch	habilidad especial para hacer algo muy bien|toque de oro
hit the ground running	empezar a trabajar enseguida con éxito|ponerse en marcha rápidamente y con éxito
cut to the chase	ir al grano|ir directo al punto
stranger than fiction	más extraño que la ficción
keep an eye on them	vigilarlos|observarlos de cerca
digs in her heels	mantenerse firme en su posición|no cambiar de opinión
let out a sigh of relief	soltar un suspiro de alivio
down the drain	al fracaso|al desastre|a la ruina
cost an arm and a leg	costar un ojo de la cara|costar un riñón
bend over backwards	hacer todo lo posible|esforzarse al máximo|sacrificarse para lograr algo
sit well with me	me hace sentir incómodo|no me convence completamente
In a nutshell	En resumen|En pocas palabras
green around the gills	tener poca experiencia|estar verde
chip on his shoulder	actitud defensiva o resentida
keep your chin up	mantenerse fuerte|mantenerse optimista|no desanimarse
dropped the ball	fallar|cometer un error grave|dejar pasar una oportunidad
put all his eggs in one basket	arriesgarlo todo en una sola cosa|jugárselo todo a solo una cosa
see eye to eye	estar de acuerdo|tener la misma opinión
right up my alley	algo que me gusta o que se me da bien.
beating a dead horse	insistir en algo que ya no tiene solución|tratar de hacer algo que ya no tiene sentido
have a cow	ponerse como loco|ponerse como una fiera|ponerse como una cabra
threw in the towel	rendirse|tirar la toalla
lean on her	contar con ella|apoyarme en ella
hammer out	trabajar duro para resolver algo|llegar a una solución después de mucho esfuerzo y trabajo
to go the extra mile	hacer un esfuerzo adicional|ir más allá de lo que se espera
stolen her thunder	haberle quitado el mérito|haberle robado la idea
caught between a rock and a hard place	estar en una situación difícil o comprometida sin saber qué hacer
fallen flat	fracasado | no tuvo éxito | no funcionó
to bite off more than I can chew	asumir más de lo que puedo manejar|asumir más de lo que puedo abarcar|asumir más de lo que puedo hacer
up in the air	incierto|en el aire|impredecible
up in smoke	fracasó|se arruinó|se fue al traste
dead in the water	sin posibilidad de éxito|paralizado|estancado
sink in	asimilar|entender completamente|comprender completamente
to hit the hay	irse a dormir | irse a la cama
running around like a chicken with its head cut off	estar corriendo de un lado a otro sin rumbo fijo|estar como pollo sin cabeza
behind the eight ball	estar en una situación difícil|estar en desventaja
in a rut	en una rutina aburrida y sin cambios
to butter me up	adularme|halagarme
the ground running	empezar a trabajar enseguida con éxito
the whole nine yards	hacer algo completamente|ir hasta el final en algo
a clean slate	un nuevo comienzo|empezar de cero
put the cart before the horse	hacer las cosas en el orden incorrecto|anticipar las cosas antes de que sea apropiado hacerlo
the box	lo convencional|lo tradicional|lo establecido
bite off more than I can chew	aceptar más de lo que puedo manejar|asumir más de lo que puedo hacer frente
her pride	su orgullo
in no time	en muy poco tiempo|en un abrir y cerrar de ojos
keep our eyes peeled	estar atentos|estar alerta|estar pendientes
to wrap his head around	comprender|entender completamente
early bird catches the worm	el que madruga, Dios le ayuda
put their nose to the grindstone	trabajar duro|intensificar el trabajo
to cut to the chase	ir al grano|ir directo al punto
whole new ballgame	una situación completamente nueva|algo completamente diferente
to pull your leg	tomarle el pelo|bromear con alguien|engañar a alguien en broma
to keep their chin up	mantenerse optimista o valiente a pesar de las dificultades
take the backseat	ceder el control|dejar que alguien más tome las decisiones
strike while the iron is hot	aprovechar el momento oportuno|actuar en el momento adecuado
breathe easy	sentirse aliviado|respirar tranquilo
a spoonful of sugar	un poco de dulzura o de humor para hacer algo más agradable o soportable
in the red	en números rojos|en pérdidas
feel under the weather	sentirse mal|estar decaído|estar triste o desanimado
hits the nail on the head	acertar en el blanco|dar en el clavo
of leeway	de libertad para actuar o decidir|de margen de maniobra
in due course	en su debido momento|a su debido tiempo
spill the beans	revelar un secreto|contar algo que no se debería contar
Bite the bullet	Tomar una decisión difícil sin vacilar.
keep their eyes peeled	estar atentos|estar alerta|estar pendientes
put our noses to the grindstone	trabajar duro|ponerse las pilas|ponerse manos a la obra
turn the tables	dar vuelta a la situación|cambiar el rumbo de los acontecimientos
fall through	fracasar|no llevarse a cabo|caerse
keep the ball rolling	mantener el impulso|seguir adelante con el proyecto
let the cat out of the bag	revelar un secreto|contar algo que se suponía debía mantenerse en secreto
hang in there	aguantar|perseverar|mantenerse firme
a blur	una confusión|un borrón
pull the wool over people's eyes	engañar a la gente|dar gato por liebre a la gente
dropping the ball	fallar|cometer un error grave|dejar pasar una oportunidad importante
pull himself together	recomponerse|ponerse en orden|recuperar la compostura
rat race	una competencia feroz y sin sentido por el éxito y el dinero
to hit the ground running	empezar a trabajar enseguida con éxito
spot on	exacto|preciso|acertado
stringing her along	hacerle creer que hay una posibilidad de relación seria, pero sin comprometerse realmente|engañarla con falsas promesas de una relación seria
a cash cow	una fuente de ingresos segura y constante
traffic jam	atasco|embotellamiento
went the whole nine yards	hacer algo completamente o con todo el esfuerzo posible.
let sleeping dogs lie	Dejar las cosas como están|No revolver el asunto
dot our i's and cross our t's	hacer las cosas con precisión y atención al detalle
paint the town red	salir de fiesta|divertirse mucho en la noche
pulled myself up by my bootstraps	hacer un gran esfuerzo para superar una dificultad o problema|levantarse por sus propios medios de una situación difícil
bail out	abandonar algo rápidamente|irse de algo rápidamente
point him in the right direction	darle las indicaciones correctas|guiarlo en la dirección correcta
to keep a stiff upper lip	mantener la compostura|mantener la calma y la profesionalidad
sleep on it	pensarlo bien|dormir sobre el asunto|reflexionar antes de tomar una decisión
fish out of water	sentirse incómodo o fuera de lugar
a laugh riot	algo muy divertido|algo muy gracioso
make or break	decisivo|clave|determinante
let off steam	desahogarse|liberar tensiones
click with you	entenderlo de repente|comprenderlo de repente
slow as molasses	muy lento|lento como un caracol
flat as a pancake	completamente fallido|sin éxito
calls the shots	tomar las decisiones|tener el control
talk the hind legs off a donkey	hablar por los codos
fly off the handle	enfadarse fácilmente|perder los estribos fácilmente
throw in the towel	rendirse|tirar la toalla
bite your tongue	morderse la lengua|guardar silencio
to get a foot in the door	conseguir una oportunidad para empezar a trabajar en una empresa o sector determinado
let their hair down	relajarse y divertirse sin preocupaciones
have a chip on her shoulder	sentirse ofendido o resentido sin motivo aparente
to keep their heads above water	mantenerse a flote|sobrevivir
beating around the bush	hablar sin llegar al punto|no ir al grano
to keep my chin up	mantenerse fuerte|mantenerse positivo
started to butt heads	empezar a tener desacuerdos o conflictos
to move the goalposts	cambiar las reglas del juego
let bygones be bygones	dejar el pasado atrás|olvidar lo que pasó y seguir adelante
keep all her ducks in a row	mantener todo en orden|tener todo bajo control
laugh his head off	reírse a carcajadas
jump out of her skin	estar tan impaciente que no se puede estar quieto o calmado
at a snail's pace	a paso de tortuga|lentamente
come out of his shell	salir de su caparazón|ser más sociable o extrovertido
get one's act together	ponerse las pilas|ponerse en orden|organizarse|prepararse adecuadamente
as cool as a cucumber	muy tranquila|imperturbable|serena
a wild-goose chase	una pérdida de tiempo|una búsqueda inútil
keep the wolf from the door	mantenerse a flote económicamente|sobrevivir económicamente
she has ants in her pants	Estar inquieto o impaciente, no poder estar quieto.
putting all their eggs in one basket	arriesgarlo todo en una sola cosa|jugárselo todo a solo una cosa
get a foot in the door	tratar de obtener información o acceso a algo o alguien de manera insistente o entrometida
burn the midnight oil	trabajar hasta muy tarde en la noche|quemar las pestañas
feather in her cap	un gran logro|un gran éxito
turn over a new leaf	empezar de nuevo|cambiar de actitud o comportamiento
have his cake and eat it too	querer tener todo|pretender tener todo|pretender tener lo mejor de ambos mundos
weight off her shoulders	sentirse aliviado|sentirse liberado
better than a poke in the eye with a sharp stick	Es mejor que nada|Es mejor que un golpe en el ojo con un palo afilado
ballpark figure	una cifra aproximada
all your eggs in one basket	arriesgarlo todo en una sola cosa|jugárselo todo a solo una cosa
actions speak louder than words	lo que haces habla más fuerte que lo que dices
with a pinch of salt	con escepticismo|con precaución
tied to the apron strings	depender demasiado de alguien, especialmente de la madre o la familia
off the top of his head	de memoria|sin pensarlo
knock on wood	tocar madera
music to my ears	música para mis oídos
in hot water	en problemas|en apuros|en dificultades
couch potato	persona que pasa mucho tiempo sentada viendo televisión o sin hacer nada
went their separate ways	se fueron por caminos separados
to look on the bright side	ver el lado positivo de las cosas
to keep my head above water	mantenerse a flote|sobrevivir a pesar de las dificultades
her bridges	todas sus posibilidades|todas sus opciones
burning a hole in my pocket	gastar dinero rápidamente|tener ganas de gastar dinero enseguida
set in his ways	ser muy terco|ser muy inflexible|no cambiar de opinión fácilmente
to play fast and loose	actuar sin escrúpulos|no respetar las reglas
to throw in the towel	rendirse|tirar la toalla
cold shoulder	trato frío o indiferente
big fish in a small pond	alguien importante en un lugar poco importante|alguien que se siente importante en un lugar poco importante
burning the midnight oil	trabajar hasta muy tarde en la noche|quemarse las pestañas
damp squib	algo que no cumple con las expectativas|algo que no tiene éxito
keep my chin up	mantenerse fuerte|mantenerse optimista|no desanimarse
take the rap	asumir la culpa|cargar con la culpa
getting the hang of it	estar cogiendo el truco|estar aprendiendo rápido
in over my head	estar en problemas demasiado grandes para manejarlos|estar en una situación demasiado difícil o complicada para manejarla
cool head	Mantener la calma bajo presión.
life of the party	la persona que anima la fiesta|el alma de la fiesta
noses to the grindstone	trabajar duro y sin descanso|estar enfocado en el trabajo y no distraerse
bigger picture	la perspectiva general|el panorama completo
get on the same page	ponernos de acuerdo|estar en la misma sintonía
off the cuff	sin preparación previa|sin pensar mucho en lo que se dice
her all	todo lo que tenía|todo su esfuerzo y energía disponible
to sweeten the pot	ofrecer algo adicional para hacer algo más atractivo o interesante
bought hook, line and sinker	creí todo lo que me dijeron|me lo creí todo sin dudar
to go the distance	llegar hasta el final|terminar lo que se empezó
to treat yourself	darse un gusto|darse un capricho|darse un lujo
spinning our wheels	estar estancados|no avanzar
silver lining	algo positivo en una situación negativa|un rayo de esperanza en una situación difícil
to hit the nail on the head	acertar en el blanco|dar en el clavo|acertar en el meollo del asunto
with a chip on her shoulder	con una actitud hostil o resentida
with a grain of salt	con escepticismo|con precaución|con reservas
to play devil's advocate	defender una postura contraria a la que se está discutiendo para generar debate o reflexión.
a social butterfly	una persona muy sociable y extrovertida
the benefit of the doubt	dar el beneficio de la duda
a bitter pill to swallow	una situación difícil de aceptar o tragar
a fish out of water	sentirse fuera de lugar|sentirse como pez fuera del agua
sell it like hotcakes	vender algo muy rápidamente y con gran éxito|vender algo muy bien y en grandes cantidades
pull out all the stops	hacer todo lo posible|poner todo de nuestra parte|dar el máximo esfuerzo
all hat, no cattle	hablar mucho pero no tener nada que lo respalde|mucho ruido y pocas nueces
to pass up	dejar pasar|rechazar
to stay ahead of the game	mantenerse por delante de la competencia|estar un paso adelante de la competencia
to turn over a new leaf	empezar de nuevo|cambiar de actitud|cambiar de rumbo
drop in the bucket	algo insignificante|algo muy pequeño en comparación con lo que se necesita o se espera
sticker shock	sorpresa desagradable por el precio de algo|susto por el precio de algo
take a rain check	posponer algo para otro momento|cancelar algo y reprogramarlo para otro momento
has her ducks in a row	tener todo bajo control|tener todo en orden
jump on the bandwagon	seguir la corriente|unirse a la moda o tendencia popular
cross the finish line	lograr el objetivo|terminar el proyecto con éxito
butterflies in his stomach	nerviosismo|mariposas en el estómago
lick my wounds	recuperarme emocionalmente después de una experiencia difícil o dolorosa
kill two birds with one stone	hacer dos cosas a la vez con un solo esfuerzo|resolver dos problemas con una sola acción
red herrings	información engañosa o distractora
of the essence	esencial|crucial|importante
she missed the boat	Ella perdió la oportunidad|Ella llegó tarde a la cita
the bush	hablar sin decir nada en concreto|no ir al grano|hablar de manera indirecta
a fly in the ointment	un problema inesperado|un obstáculo imprevisto
you're tilting at windmills	You are wasting your time and energy on something that is impossible or unlikely to succeed.
keep an eye on him	vigilarlo|estar atento a él
moving the goalposts	cambiar las reglas del juego|cambiar los objetivos
playing both sides	jugar a dos bandas|tener doble juego
robbing Peter to pay Paul	usar el dinero de una cosa para pagar otra cosa|robar a Pedro para pagar a Pablo
cold feet	tener dudas o miedo a hacer algo que se había planeado o decidido hacer, especialmente algo importante o que implica un compromiso.
up the creek without a paddle	en problemas serios sin solución aparente|en una situación difícil sin recursos ni ayuda
silver spoon in her mouth	haber nacido en cuna de oro|haber nacido en una familia adinerada
hitting the hay	irse a dormir | irse a la cama
the real McCoy	la cosa auténtica o genuina|la verdadera cosa
stirring the pot	crear problemas|provocar conflictos
take the bull by the horns	enfrentar un problema directamente|tomar el toro por las astas
live it up	vivir a lo grande|disfrutar al máximo|vivir la vida loca
back in the saddle	volver a estar en control|volver a estar en el juego|volver a estar en acción
jump ship	cambiar de trabajo abruptamente|abandonar un trabajo sin previo aviso
play my cards right	actuar de manera astuta o inteligente para lograr lo que se quiere|jugar bien las cartas
pushing the envelope	ir más allá de los límites establecidos|explorar nuevas posibilidades o límites
get off her high horse	dejar de ser arrogante o pretenciosa|bajar de su pedestal
cut corners	hacer algo de manera más rápida o económica, pero sin hacerlo de la manera correcta o completa.
put your nose to the grindstone	trabajar duro y concentrarse en algo para lograrlo|esforzarse al máximo para lograr algo
flies off the handle	enfadarse mucho|rabiarse
go back to square one	volver a empezar desde cero|volver al punto de partida
hit rock bottom	llegar al fondo|tocar fondo|estar en el peor momento de su vida
point me in the right direction	dar una orientación adecuada|indicar el camino correcto a seguir
the name of the game	la norma|la regla
rocket science	algo muy complicado o difícil de entender
hold my horses	esperar un momento|tener paciencia
in the dark	sin entender|sin saber lo que está pasando|en la ignorancia
go the extra mile	hacer un esfuerzo adicional|hacer más de lo que se espera
kick the bucket	morir
burn that bridge when we come to it	Tomar una decisión difícil en el futuro, cuando sea necesario, sin preocuparse por las consecuencias.
brick wall	un obstáculo insuperable|una barrera infranqueable
chicken out	echarse atrás|rajarse|acobardearse
have butterflies in his stomach	sentir mariposas en el estómago|tener nervios
a chip on my shoulder	sentir resentimiento o enojo por algo que sucedió en el pasado y que todavía afecta a la persona
laugh their head off	reírse a carcajadas
all hands on deck	todos a la obra|todos a la carga
under wraps	en secreto|en confidencia|en privado
to beat around the bush	hablar sin llegar al punto|no ir al grano
wet behind the ears	inexperto|novato|sin experiencia
in order	en orden|bien organizados|bien estructurados
nip it in the bud	solucionarlo ahora antes de que empeore|cortar de raíz el problema ahora
took the plunge	tomar la decisión difícil o arriesgada de hacer algo, especialmente algo que se ha estado posponiendo o que se considera importante o significativo.
bring home the bacon	lograr el éxito financiero de la empresa|asegurar el éxito financiero de la empresa
big break	gran oportunidad|gran éxito
out of the blue	inesperado|de repente|sin previo aviso
blank out	quedarse en blanco|olvidar todo lo que se sabe
feeling under the weather	sentirse mal|enfermarse
sit on her hands	no hacer nada|quedarse de brazos cruzados
went out the window	desaparecieron|se fueron
feeling jittery	sentirse nervioso|inquieto|agitado
by the wayside	quedar en el olvido|fracasar
get away from it all	alejarse de todo|escapar de todo
cash cow	fuente de ingresos seguros y constantes | negocio rentable y seguro
off the charts	fuera de lo común|fuera de serie|increíblemente bueno
to heart	tomar algo a pecho
flash in the pan	algo que parece prometedor al principio pero que no tiene éxito a largo plazo
dogged determination	determinación firme|tenacidad incansable
meeting of the minds	acuerdo mutuo|consenso
burn any bridges	no cerrar puertas|no quemar puentes
bite my tongue	guardar silencio|contenerse para no decir algo
to break the ice	romper el hielo|iniciar una conversación
to clean house	hacer limpieza|limpiar la casa
to call it a day	decidir terminar algo|dar algo por terminado|abandonar algo
walking on eggshells	sentirse incómodo o inseguro alrededor de alguien, como si estuviera pisando huevos sin romperlos
fair weather	tiempo agradable|buen tiempo
to get our foot in the door	conseguir una oportunidad inicial o una entrada en un lugar o situación difícil de acceder.
count her chickens before they hatched	dar algo por hecho antes de que suceda|anticipar algo que aún no ha sucedido
Burning the midnight oil	quemarse las pestañas|trabajar hasta muy tarde en la noche
keep your head above water	mantenerse a flote|sobrevivir financieramente
put two and two together	juntar las piezas del rompecabezas|unir los puntos
black and white	sencillo o claro|bueno o malo|blanco o negro
missed the boat	perder una oportunidad|llegar tarde a algo que ya no se puede hacer
fast learner	persona que aprende rápido
let it all hang out	expresarse libremente|decir todo lo que piensa sin restricciones
walk the walk	demostrar con acciones lo que se dice con palabras|respaldar las palabras con acciones
your foot in the door	conseguir una oportunidad inicial o un pie en el mundo laboral
get our ducks in a row	organizarnos|ponernos en orden|prepararnos adecuadamente
to have her cake and eat it too	querer tener todo a la vez|pretender tenerlo todo
have bigger fish to fry	tener problemas más importantes que atender|tener asuntos más graves que resolver
let my hair down	relajarme|desinhibirme
has a heart of gold	tener un corazón de oro
put my two cents in	dar mi opinión|meter baza|meter cuchara
the pedal to the metal	hacer algo con mucha energía o rapidez|acelerar el ritmo de algo
spilling the beans	revelar un secreto|contar algo que no se debía contar
outside the box	fuera de lo convencional|pensar de manera creativa y original
a thorn in my side	algo que me molesta o me causa problemas constantemente
making waves	causando sensación|generando impacto
lame duck	persona o cosa que no tiene éxito o no funciona bien|excusa poco convincente
all mouth and no trousers	hablar mucho pero no hacer nada|mucho ruido y pocas nueces
practice makes perfect	la práctica hace al maestro
brownie points	puntos extras|crédito extra|reconocimiento extra
a can of worms	una situación complicada o problemática que se desencadena a partir de una acción o decisión
deer caught in headlights	persona que se queda paralizada sin saber qué hacer o decir en una situación inesperada o estresante.
more harm than good	más daño que beneficio
the bag	NA
a stiff upper lip	mantener la compostura|no mostrar debilidad o emoción ante la adversidad
blew her top	perder los estribos|perder la paciencia
to tighten our belts	ajustarnos el cinturón|apretarnos el cinturón
to stay above water	mantenerse a flote|no dejarse vencer por las dificultades
finger-licking good	delicioso/a (que te chuparás los dedos)|para chuparse los dedos
to face the music	afrontar las consecuencias de algo que se ha hecho o que ha sucedido, especialmente si son desagradables o negativas.
to fit a square peg into a round hole	tratar de encajar algo que no encaja|forzar algo para que encaje
be a breath of fresh air	ser algo nuevo y refrescante|ser un cambio positivo y renovador
get back on the horse	volver a intentarlo|retomar algo después de un fracaso o una dificultad
to be ahead of the curve	estar a la vanguardia|estar a la cabeza
to bark up the wrong tree	equivocarse de objetivo|buscar en el lugar equivocado|dirigirse a la persona equivocada
made the cut	haber cumplido con los requisitos|haber sido seleccionado/a
to bring home the bacon	lograr el éxito financiero|ganar dinero
To make a long story short	para resumir|en resumen|en pocas palabras
lean on	contar con alguien|apoyarse en alguien
rock the boat	evitar problemas o conflictos innecesarios|no causar problemas o conflictos innecesarios
shoulder to cry on	alguien que te escuche y te apoye emocionalmente|un hombro en el que llorar
kill them with kindness	tratar a alguien difícil con amabilidad para desarmarlo o ganárselo
at a low ebb	en baja|en un momento de depresión o desánimo
on the ball	estar alerta|estar atento|estar al tanto
pull it off	lograr algo con éxito|conseguir algo con éxito
perseverance pays off	la perseverancia tiene recompensa|el esfuerzo tiene su recompensa
land on his feet	salir bien parado|resolver la situación con éxito
take your eye off the ball	distraerse de lo importante|perder de vista el objetivo
cutting the mustard	haciendo un buen trabajo|demostrando ser competente en su trabajo
feel the burn	sentir el cansancio|estar agotado
grin from ear to ear	sonreír de oreja a oreja
cup of tea	algo que le gusta mucho|algo que le apasiona
pat on the back	palabras de aliento|apoyo moral
peaches and cream	todo es perfecto|todo es maravilloso
on edge	nervioso|tenso|inquieto
pinch of salt	"figurative translation of ""a pinch of salt"" is to add a small amount of skepticism or doubt to something."
close to his chest	guardar algo para uno mismo|no compartir información con nadie
cutting it too thin	dejar muy poco tiempo|estar muy ajustado de tiempo
midnight oil	trabajar hasta muy tarde en la noche|quemar las pestañas
guts and grit	coraje y determinación
moving full steam ahead	avanzando a toda máquina|avanzando a toda velocidad
play both sides	tener doble juego|jugar a dos bandas
stay put	quedarse donde estás|no moverse de donde estás
Biting the bullet	Afrontar una situación difícil con valentía o resignación.
you can't have your cake and eat it too	No se puede tener todo en la vida|No se puede tener el cielo y la tierra
pulling my leg	tomándome el pelo|bromeando conmigo
pulled the rug out from under me	sentir que el suelo se mueve bajo mis pies|sentir que me han quitado el suelo de debajo de los pies
Barking up the wrong tree	Buscar en el lugar equivocado|Estar equivocado en la búsqueda
budge an inch	no ceder ni un ápice|no cambiar de opinión
running on fumes	estar agotado|estar sin energía|estar al límite
off the wall	fuera de lugar|inapropiado|extraño
raining on our parade	arruinar nuestra diversión|aguar nuestra fiesta
playing with fire	hacer algo peligroso o arriesgado|jugar con fuego
hunker down	prepararse para una situación difícil o peligrosa|refugiarse
cross that bridge when I come to it	Preocuparse por algo solo cuando llegue el momento|No preocuparse por algo hasta que sea necesario
the good fight	la buena lucha | la buena batalla
take the plunge	tomar la iniciativa|atreverse a hacer algo que implica un riesgo
the blues	sentimiento de tristeza o depresión sin causa aparente.
turn things around	dar un giro a las cosas|cambiar el rumbo de las cosas|mejorar la situación
be there for her	apoyarla|estar ahí para ella
sweep them under the rug	ignorarlos|ocultarlos|no prestarles atención
cooking the books	falsificar las cuentas|maquillar las cuentas
broke the ice	romper el hielo
the real deal	la auténtica cosa|lo genuino|lo auténtico|lo verdadero|lo auténtico y genuino
take a load off	descansar|relajarse
a bunch of baloney	una excusa sin sentido|una excusa inventada
thin ice	situación peligrosa o arriesgada
batting an eye	sin pestañear|sin inmutarse
chickens out	echarse atrás|acobardarse|arrugar
burn bridges	romper relaciones|cortar lazos
keep our ducks in a row	tener todo organizado|tener todo bajo control|tener todo en orden
behind closed doors	en secreto|en privado|a puerta cerrada
pull the wool over my eyes	engañarme|tratar de engañarme
throwing money down the drain	tirar el dinero|tirar el dinero por la ventana
come back to bite him	su comportamiento le traerá consecuencias negativas en el futuro|su comportamiento le pasará factura en el futuro
apple pie	algo muy común o típico
cabin fever	sentirse atrapado o aburrido por estar en un lugar cerrado durante mucho tiempo
put all our eggs in one basket	arriesgarlo todo en una sola cosa|jugárnoslo todo a solo una cosa
have a bee in his bonnet	estar obsesionado con algo|tener una idea fija en la cabeza
add up	tener sentido|cuadrar|ser coherente
chasing her tail	estar muy ocupado pero sin avanzar en nada|estar dando vueltas sin lograr nada
beat a dead horse	insistir en algo que ya no tiene sentido|darle vueltas a algo que ya no tiene solución
count your chickens before they hatch	dar algo por seguro antes de que suceda|contar con algo que aún no ha sucedido
to kill two birds with one stone	hacer dos cosas a la vez|resolver dos problemas con una sola acción
keep his eye on the ball	prestar atención|estar concentrado en lo que se está haciendo
cloud nine	estar en la cima del mundo|estar en la gloria|estar en la nube nueve
wrong tree	equivocado en la elección de persona o cosa a la que se dirige o se busca.
read between the lines	leer entre líneas|interpretar lo que no se dice explícitamente
monkey business	actividades no serias o inapropiadas durante el horario de trabajo
sting in the tail	una sorpresa desagradable al final|una trampa al final
landing on his feet	salir bien parado de una situación difícil
bee in her bonnet	obsesión por algo, especialmente algo que no es importante o que no tiene solución.
not the end of the world	no es el fin del mundo
social butterfly	persona muy sociable|alma de la fiesta
not his cup of tea	no es lo suyo|no es de su agrado
march to the beat of your own drum	Ser uno mismo|Hacer lo que uno cree que es correcto sin importar lo que piensen los demás
get her feet wet	adquirir experiencia en algo nuevo|adaptarse a una nueva situación
stop and smell the roses	tomarse un momento para disfrutar de las cosas simples de la vida|disfrutar de las pequeñas cosas de la vida
step up their game	mejorar su rendimiento|dar lo mejor de sí
take it easy	tomárselo con calma|relajarse|descansar
showed his true colors	mostró su verdadera personalidad|mostró su verdadera cara
bunch of hogwash	mentiras|tonterías|disparates
beauty contest	competencia reñida|competencia dura|competencia fuerte
the bee's knees	algo excelente|algo maravilloso|lo mejor de lo mejor
keep her head above water	mantenerse a flote|sobrevivir
death warmed over	parecer muerto en vida
a big fish in a small pond	una persona importante en un ámbito limitado
can stomach	pueda soportar|pueda aguantar
sweating bullets	sudando la gota gorda
a bee in her bonnet	obsesión|idea fija
in over his head	estar en problemas|estar en aprietos|estar en dificultades|estar en una situación que no se puede manejar
lend a hand	ayudar
in the bag	seguro|garantizado|en el bolsillo
has bees in his bonnet	obsessed with something, especially an idea or plan
miss the boat	perder una oportunidad|quedarse atrás
had bats in her belfry	estar loca o chiflada
rest on his laurels	descansar en los logros pasados|conformarse con los logros pasados
put all her eggs in one basket	arriesgarlo todo en una sola cosa|jugárselo todo a solo una cosa
chip off the old block	una persona que se parece mucho a otra, especialmente a su padre o madre
buried her head in the sand	ignorar el problema|evadir el problema|no querer enfrentar el problema
touch base	ponerse en contacto|comunicarse
there's no tomorrow	como si no hubiera un mañana
at loggerheads	estar en desacuerdo|estar en conflicto
the elephant in the room	un tema incómodo o evidente que nadie quiere mencionar o discutir
put their best foot forward	presentarse de la mejor manera posible|dar una buena impresión
keep his cool	mantener la calma
put her foot in her mouth	decir algo inapropiado o embarazoso sin querer
hold your horses	esperar un momento|tener paciencia
stealing the show	acaparar la atención|robarse el espectáculo
wears his heart on his sleeve	mostrar sus sentimientos abiertamente
to mind her own beeswax	ocuparse de sus propios asuntos
cracked the whip	ejercer autoridad de manera dura|ser muy exigente con los empleados
to keep her head above water	mantenerse a flote|sobrevivir a pesar de las dificultades
skeletons in the closet	secretos oscuros del pasado
the skin of his teeth	por los pelos|por muy poco
not to take things personally	no tomarse las cosas de manera personal|no tomarse las cosas a pecho
Biting off more than you can chew	Intentar hacer más de lo que se puede manejar o asumir más responsabilidades de las que se pueden cumplir.
put his two cents in	dar su opinión sin ser solicitada|meterse en lo que no le importa
keep an eye out	estar pendiente|vigilar
shooting for the moon	intentar algo muy ambicioso o difícil de lograr.
changes horses midstream	cambiar de opinión o de estrategia en medio de un proyecto o tarea|cambiar de caballo a mitad del río
thrown for a loop	sorprendidos|desconcertados|desorientados
jump through hoops	hacer todo lo posible para cumplir con las exigencias de alguien|hacer esfuerzos extraordinarios para lograr algo
letting her hair down	relajándose y divirtiéndose sin preocupaciones|soltándose el pelo
lose sleep over something	preocuparse mucho por algo|no poder dormir por algo
get his ducks in a row	organizar sus ideas|poner todo en orden
hit it out of the park	hacer algo excepcionalmente bien|tener un gran éxito
manage her time better	aprender a administrar su tiempo mejor|mejorar su gestión del tiempo
fishy going on	algo sospechoso está pasando
reap what he sows	cosechar lo que ha sembrado|recoger los frutos de su esfuerzo
going around in circles	hacer algo sin avanzar o progresar|estar dando vueltas sin llegar a ningún lado
stick with it	perseverar|aguantar hasta el final
on top of the world	sentirse en la cima del mundo|sentirse en la gloria
let his hair down	relajarse|desmelenarse
keep your eye on the ball	estar concentrado en lo que se está haciendo|no perder de vista el objetivo
fair shake	oportunidad justa|trato justo
steals the show	acapara la atención|se lleva todo el protagonismo
get them straightened out	poner en orden|arreglar|organizar
the best thing since sliced bread	lo mejor que ha pasado en mucho tiempo|lo mejor que hay
burning the candle at both ends	trabajar demasiado|trabajar sin descanso
carved out a successful career	lograr una carrera exitosa|forjar una carrera exitosa
the ball	la responsabilidad|el control
made it big	tener éxito rotundo|triunfar en grande
dance to your own tune	hacer lo que uno quiere sin importar lo que piensen los demás|seguir su propio camino sin importar la opinión de los demás
to keep your eye on the ball	mantenerse enfocado en el objetivo|no perder de vista el objetivo
let her hair down	relajarse|desinhibirse
keeping her in the dark	mantenerla en la ignorancia|no informarla de todo lo que pasa
in a pickle	en un aprieto|en un dilema
throwing in the towel	rendirse|abandonar
on the wrong side of the bed	de mal humor|de mal genio|con el pie izquierdo
the brass ring	el éxito más alto posible|el premio más importante
test the waters	probar los límites|explorar los límites
six of one and half a dozen of the other	ambas partes son igualmente culpables o responsables|seis de una y media docena de la otra
seeing red	estar muy enojado
blow their socks off	Impresionarlos mucho|Dejarlos boquiabiertos
to let off steam	desahogarse|liberar tensiones
a shot in the dark	algo incierto|algo que se hace sin saber si tendrá éxito o no
the green light	la aprobación|la luz verde
hot water	problemas|dificultades|aprietos
to see stars	sentir mareo o vértigo
woke up on the wrong side of the bed	levantarse con el pie izquierdo|levantarse de mal humor
rain check	posponer una cita o un plan para otro momento.
blow his own trumpet	alabarse a sí mismo|presumir de sí mismo
shaken like a leaf	temblando como una hoja
a tough cookie	una tarea difícil|un hueso duro de roer
black ice	hielo negro
in her element	en su elemento|en su salsa
on pins and needles	estar en ascuas|estar en vilo|estar nervioso o ansioso por algo que va a suceder pronto
a rock and a hard place	estar entre la espada y la pared
old hat	algo que ya no es novedad|algo que ya está pasado de moda
hit the road	irse|partir
a few tricks up their sleeve	algunos trucos bajo la manga|algunos ases en la manga
to rock the boat	crear problemas o conflictos innecesarios|alterar el status quo
to hit the sack	irse a la cama|acostarse
to follow one's heart	seguir su corazón|seguir su pasión
to get the ball rolling	iniciar algo|poner en marcha algo|empezar algo
to turn the corner	superar un obstáculo|dar un giro positivo a una situación difícil
to see the light at the end of the tunnel	ver la luz al final del túnel
fishing in troubled waters	meterse en problemas innecesarios|buscar problemas donde no los hay
to take the bull by the horns	tomar el toro por las astas
out of this world	fuera de serie|fuera de este mundo|impresionante
cracked a smile	sonreírse ni siquiera un poco
on the same page	estar en la misma sintonía|estar de acuerdo en algo
let you off the hook	perdonar|dejar pasar|librar de culpa|eximir de responsabilidad
silly goose	tonto|bobo|ingenuo
turning the tables	darle la vuelta a la situación|invertir los papeles
cross that bridge when we come to it	ocuparse del problema cuando llegue|preocuparse del problema cuando llegue el momento
hit it off	llevarse bien|conectar bien|caerse bien
blow off some steam	desahogarse|liberar tensiones
living in a dream world	vivir en las nubes|vivir en un mundo de fantasía
green behind the ears	inexperta|novata|sin experiencia
all thumbs	torpe|patoso
bag of rags	desaliñada|hecha un desastre|hecha un guiñapo
loose ends	asuntos pendientes|cabos sueltos
around the block	tener experiencia en algo|haber pasado por algo varias veces
more than I can chew	más de lo que puedo manejar|mas de lo que puedo abarcar
paying off	está dando resultados|está dando frutos|está funcionando
blew my mind	me dejó impresionado|me dejó asombrado|me dejó boquiabierto
see eye-to-eye	tener una comprensión mutua|estar de acuerdo
big cheese	persona importante|persona influyente|persona poderosa
a tempest in a teapot	una tormenta en un vaso de agua
make time	sacar tiempo|hacer tiempo disponible
count our chickens before they hatch	dar algo por seguro antes de que suceda|dar algo por hecho antes de que suceda
water under the bridge	algo que ya pasó y no tiene importancia|algo que ya se superó y no hay resentimientos
throws a curveball	sorprende con algo inesperado o difícil de manejar
just what the doctor ordered	exactamente lo que se necesita|justo lo que el médico recetó
too little too late	demasiado poco y demasiado tarde
put all my eggs in one basket	arriesgarlo todo en una sola cosa|jugármelo todo a solo una cosa
rubbing salt in my wounds	echar sal en la herida|agravar la situación
fly by the seat of his pants	hacer las cosas sobre la marcha|improvisar
get lost	irse|largarse|perderse
knowledge is power	el conocimiento es poder
meet halfway	llegar a un acuerdo|ceder en algo para llegar a un acuerdo
keeping their eye on the ball	Mantenerse enfocado en el objetivo|No perder de vista el objetivo
paid through the nose	pagar un precio excesivo|pagar demasiado caro
kick back and relax	relajarse|descansar
keep their noses to the grindstone	trabajar duro|dedicarse con esfuerzo y constancia al trabajo
get your ducks in a row	organizar todo de manera adecuada antes de comenzar un proyecto nuevo
be at each other's throats	estar siempre discutiendo o peleando por cosas pequeñas
stand their ground	mantenerse firme en sus opiniones o posturas
couldn't see the forest for the trees	No poder ver la situación en su conjunto por estar demasiado concentrado en los detalles.
Time flies	El tiempo pasa volando.
burst a blood vessel	enfadarse muchísimo|ponerse furioso/a
get down to brass tacks	ir al grano|ir al meollo del asunto
the wrong side of the bed	levantarse con el pie izquierdo|levantarse de mal humor
picks up the tab	pagar la cuenta
knocked it out of the park	lo hizo excepcionalmente bien|lo hizo de manera sobresaliente
keep his head above water	mantenerse a flote|sobrevivir financieramente
has a chip on her shoulder	sentirse ofendido o resentido por algo que ha sucedido en el pasado y que todavía afecta su actitud o comportamiento presente.
knows the ropes	saber cómo funcionan las cosas|conocer los procedimientos
set in their ways	ser inflexible|tener ideas fijas|ser terco
bit my tongue	guardar silencio|no decir nada
find his feet	adaptarse|encontrar su camino|encontrar su lugar
in one ear and out the other	escuchar sin prestar atención|no prestar atención a lo que se escucha
back to square one	volver al punto de partida|volver a empezar desde cero
come true	hacerse realidad|cumplirse
beats around the bush	hablar sin decir nada en concreto|no ir al grano
a flash in the pan	Something that initially shows great promise but quickly fails or disappoints.
hit the hay early	irse a dormir temprano
lost her marbles	perder la cabeza|perder el juicio
wild card	persona impredecible | elemento sorpresa
a little birdie told me	Alguien me dijo|Me llegó al oído
getting our ducks in a row	organizándonos|poniendo todo en orden
to count his chickens before they hatch	dar algo por seguro antes de que suceda|dar algo por hecho antes de que suceda
to grin and bear it	aguantar el mal trago|soportar algo desagradable sin quejarse
control freak	persona obsesiva por el control|maníaco del control
took a rain check	posponer una cita o un plan para otro momento
live wire	una persona muy activa y llena de energía
chill out	relajarse|descansar
off her chest	decir todo lo que se tiene que decir|sacar algo de encima
down for the count	fuera de combate|noqueado
light at the end of the tunnel	esperanza de que algo mejore en el futuro|una solución o salida cercana a una situación difícil
to open a can of worms	abrir un tema delicado|abrir un tema polémico
make hay while the sun shines	aprovechar el momento oportuno|aprovechar el buen tiempo mientras dure
find a needle in a haystack	encontrar una aguja en un pajar
not even a crumb	ni una miga|ni un pedacito
hit the sack	irse a la cama|irse a dormir
butterflies in your stomach	nerviosismo|mariposas en el estómago
to put on a brave face	tratar de aparentar valentía o fortaleza ante una situación difícil o dolorosa.
to pull out all the stops	hacer todo lo posible|poner todo de nuestra parte|dar lo mejor de nosotros
a dish that steals the show	un plato que se roba el espectáculo|un plato que acapara la atención
fail by a country mile	fracasar estrepitosamente|fracasar por mucho
to shoot your shot	intentar algo, especialmente algo que parece difícil o arriesgado, sin importar el resultado final.
to keep his head above water	mantenerse a flote|sobrevivir a pesar de las dificultades
to prove them all wrong	demostrar que todos estaban equivocados
tie the knot	casarse
take it with a grain of salt	tomar algo con escepticismo|no creer algo completamente
pull someone's leg	tomarle el pelo a alguien|bromear con alguien
skip a beat	sentir una fuerte emoción|sentir mariposas en el estómago
to put my best foot forward	dar la mejor impresión posible|presentarse de la mejor manera posible
keep his nose to the grindstone	trabajar duro y sin descanso|estar enfocado en el trabajo y no distraerse
get back on her feet	recuperarse|levantarse de nuevo|volver a empezar
