www.stylehub.com	www.stylehub.com
www.cookingqueen.net	www.cookingqueen.net
www.newsworld.com	www.newsworld.com
www.fitlife.xyz	www.fitlife.xyz
www.skywayairlines.com	www.skywayairlines.com
www.artisanshoppe.com	www.artisanshoppe.com
www.clearskinlab.com	www.clearskinlab.com
www.cinemabooking.net	www.cinemabooking.net
www.codeacademy.org	www.codeacademy.org
www.travelbug.com	www.travelbug.com
www.vintageboutique.co	www.vintageboutique.co
www.fitnesshub.xyz	www.fitnesshub.xyz
www.foodblogger.net	www.foodblogger.net
www.musicfestival.com	www.musicfestival.com
www.flowerpedia.org	www.flowerpedia.org
www.craftyartists.com	www.craftyartists.com
www.autotechfixers.com	www.autotechfixers.com
www.yogamoves.us	www.yogamoves.us
www.stylecentral.co	www.stylecentral.co
www.bakeitup.biz	www.bakeitup.biz
www.electrodeals.net	www.electrodeals.net
www.catsrule.com	www.catsrule.com
www.stylehub.online	www.stylehub.online
www.farmersmarketplace.co	www.farmersmarketplace.co
www.budgetvacations.com	www.budgetvacations.com
www.mymamaskitchen.mx	www.mymamaskitchen.mx
www.beautyvault.com	www.beautyvault.com
www.gymfreaks.io	www.gymfreaks.io
www.carsales.net	www.carsales.net
www.furnitureheaven.co	www.furnitureheaven.co
www.explorationzone.com	www.explorationzone.com
www.flightcompare.net	www.flightcompare.net
www.fashionista.com	www.fashionista.com
www.learnmore.edu	www.learnmore.edu
www.tastyfood.net	www.tastyfood.net
www.getfitnow.co	www.getfitnow.co
www.artisticdepot.com	www.artisticdepot.com
www.greenharvestfoods.com	www.greenharvestfoods.com
www.grocerydirect.com	www.grocerydirect.com
www.newsworthy.net	www.newsworthy.net
www.fitnessequipment.com	www.fitnessequipment.com
www.makemoneyfast.biz	www.makemoneyfast.biz
www.nationalgallery.org	www.nationalgallery.org
www.greatproductsincorporated.com	www.greatproductsincorporated.com
www.airbnb.es	www.airbnb.es
www.bookriot.com	www.bookriot.com
www.ticketmaster.com	www.ticketmaster.com
www.gamingcenter.net	www.gamingcenter.net
www.nutritioncare.com	www.nutritioncare.com
www.hikingclothingstore.com	www.hikingclothingstore.com
www.artpedia.org	www.artpedia.org
www.techshop.us	www.techshop.us
www.travelguide.com	www.travelguide.com
www.mindgames.net	www.mindgames.net
www.beautyfinds.com	www.beautyfinds.com
www.sneakerplanet.com	www.sneakerplanet.com
www.successmindset.co	www.successmindset.co
www.officialsite.com	www.officialsite.com
www.ticketvendor.net	www.ticketvendor.net
www.kitchenstore.com	www.kitchenstore.com
www.bookinghub.co	www.bookinghub.co
www.electronicsmarketplace.com	www.electronicsmarketplace.com
www.newsfeed.com	www.newsfeed.com
www.gamerspot.net	www.gamerspot.net
www.travelworld.com	www.travelworld.com
www.jobsearchportal.com	www.jobsearchportal.com
www.foodbloggers.com	www.foodbloggers.com
www.technewsdaily.com	www.technewsdaily.com
www.bookingpros.com	www.bookingpros.com
www.videogamezone.org	www.videogamezone.org
www.shutterbug.com	www.shutterbug.com
www.sportnews.net	www.sportnews.net
www.fashionstore.com	www.fashionstore.com
www.musicstreamingplatform.us	www.musicstreamingplatform.us
www.shopnow.com	www.shopnow.com
www.recipesgalore.net	www.recipesgalore.net
www.learnnewskills.org	www.learnnewskills.org
www.photographyhub.net	www.photographyhub.net
www.yogawear.com	www.yogawear.com
www.hardwarehub.net	www.hardwarehub.net
www.bakeryblog.org	www.bakeryblog.org
www.papergoods.co.nz	www.papergoods.co.nz
www.ticketmarketplace.us	www.ticketmarketplace.us
www.beautyhaven.com	www.beautyhaven.com
www.greenfingers.com	www.greenfingers.com
www.supportdesk.com	www.supportdesk.com
www.thegoodplace.net	www.thegoodplace.net
www.freshmarketplace.ca	www.freshmarketplace.ca
www.glamorouslifehub.com	www.glamorouslifehub.com
www.bookaway.co	www.bookaway.co
www.driveeasyrentals.com	www.driveeasyrentals.com
www.adventuregearzone.com	www.adventuregearzone.com
www.techguruworld.blogspot.com	www.techguruworld.blogspot.com
www.newsflash.com	www.newsflash.com
www.artgallery.net	www.artgallery.net
www.coffeeroasters.org	www.coffeeroasters.org
www.gardencentral.com	www.gardencentral.com
www.healthyfoodie.com	www.healthyfoodie.com
www.foodbloggersofamerica.com	www.foodbloggersofamerica.com
www.fashioniste.co.in	www.fashioniste.co.in
www.currentstate.report	www.currentstate.report
www.backpackerstravelogue.com	www.backpackerstravelogue.com
www.bridalfaironline.com	www.bridalfaironline.com
www.workflowpros.com	www.workflowpros.com
www.technews.net	www.technews.net
www.playmastermind.com	www.playmastermind.com
www.diyideas.com	www.diyideas.com
www.gamerzone.co.nz	www.gamerzone.co.nz
www.cuisinemasterchef.com	www.cuisinemasterchef.com
www.jobsearchpros.com	www.jobsearchpros.com
www.laughingbuddha.com	www.laughingbuddha.com
www.songlyricsfinder.org	www.songlyricsfinder.org
www.skincareproducts.us	www.skincareproducts.us
www.homedecorstore.co	www.homedecorstore.co
www.scientificjournal.org	www.scientificjournal.org
www.sportswear.com	www.sportswear.com
www.gourmetfoodmarket.net	www.gourmetfoodmarket.net
www.discountfurniturestore.com	www.discountfurniturestore.com
www.musicstreamingplatform.com	www.musicstreamingplatform.com
www.petstoreonline.com	www.petstoreonline.com
www.writingacademy.xyz	www.writingacademy.xyz
www.fashionhub.com	www.fashionhub.com
www.cookbook.org	www.cookbook.org
www.techdailynews.net	www.techdailynews.net
www.electronicsrus.com	www.electronicsrus.com
www.ikea.com	www.ikea.com
www.travelzone.net	www.travelzone.net
www.pressupdate.com	www.pressupdate.com
www.clothesmart.co.nz	www.clothesmart.co.nz
www.tradingpros.com	www.tradingpros.com
www.educationhub.org	www.educationhub.org
www.pawsandclaws.com.au	www.pawsandclaws.com.au
www.thinktank.edu	www.thinktank.edu
www.giftland.ca	www.giftland.ca
www.webdesignerplus.com	www.webdesignerplus.com
www.gotrip.com	www.gotrip.com
www.todolist.net	www.todolist.net
www.poetrygalore.com	www.poetrygalore.com
www.homedecorideas.net	www.homedecorideas.net
www.tastyandhealthy.com	www.tastyandhealthy.com
www.brainboosters.org	www.brainboosters.org
www.funkytownvintage.com	www.funkytownvintage.com
www.learnonline.edu	www.learnonline.edu
www.sofastore.co	www.sofastore.co
www.trippyvacationdeals.com	www.trippyvacationdeals.com
www.naturalfarmacycosmetics.com	www.naturalfarmacycosmetics.com
www.travelhub.net	www.travelhub.net
www.stocktrading.com	www.stocktrading.com
www.fashionzone.it	www.fashionzone.it
www.yogastudio.co.nz	www.yogastudio.co.nz
www.creativebeadworks.com	www.creativebeadworks.com
www.servicematch.ca	www.servicematch.ca
www.gardeningworld.com	www.gardeningworld.com
www.customsguide.com	www.customsguide.com
www.epicurious.com	www.epicurious.com
www.bbc.com	www.bbc.com
www.joyfuljewels.com	www.joyfuljewels.com
www.outdoorsupply.com	www.outdoorsupply.com
www.duolingo.com	www.duolingo.com
www.yelp.com	www.yelp.com
www.airbnb.co.jp	www.airbnb.co.jp
www.skyscanner.net	www.skyscanner.net
www.thriftedtreasures.com	www.thriftedtreasures.com
www.paypal.com	www.paypal.com
www.schoolofbusiness.edu	www.schoolofbusiness.edu
www.cinemahouse.net	www.cinemahouse.net
www.travelblog.co	www.travelblog.co
www.allnewsnow.com	www.allnewsnow.com
www.uptimehosting.net	www.uptimehosting.net
www.fashiondome.com	www.fashiondome.com
www.techwatchers.org	www.techwatchers.org
www.thefoodvault.com	www.thefoodvault.com
www.financialinsightsforum.com	www.financialinsightsforum.com
www.learninghub.org	www.learninghub.org
www.languagehub.net	www.languagehub.net
www.glowbeauty.com	www.glowbeauty.com
www.trendystylez.net	www.trendystylez.net
www.flyawaydeals.com	www.flyawaydeals.com
www.shopfreshmarket.com	www.shopfreshmarket.com
www.justicefirm.co.uk	www.justicefirm.co.uk
www.greenharvestfarm.com	www.greenharvestfarm.com
www.travelplannerpro.com	www.travelplannerpro.com
www.catsdailyfun.com	www.catsdailyfun.com
www.readbyear.com	www.readbyear.com
www.musicstream.net	www.musicstream.net
www.cookinglibrary.com	www.cookinglibrary.com
www.technewswire.com	www.technewswire.com
www.planettrips.net	www.planettrips.net
www.librarysearch.edu	www.librarysearch.edu
www.petshopworld.com	www.petshopworld.com
www.onlinegrocery.com	www.onlinegrocery.com
www.officemail.org	www.officemail.org
www.learnersclub.net	www.learnersclub.net
www.flyhighairlines.ca	www.flyhighairlines.ca
www.bakeitnow.com	www.bakeitnow.com
www.greenadventures.travel	www.greenadventures.travel
www.onlineplatforms.net	www.onlineplatforms.net
www.freshharvestmarket.org	www.freshharvestmarket.org
www.gohikingmaps.com	www.gohikingmaps.com
www.petstore.net	www.petstore.net
www.retrofashion.com	www.retrofashion.com
www.techsale.com	www.techsale.com
www.eaterymenu.com	www.eaterymenu.com
www.wanderlustpics.com	www.wanderlustpics.com
www.indiesound.com	www.indiesound.com
www.crafterssupply.net	www.crafterssupply.net
www.helpdeskpros.com	www.helpdeskpros.com
www.farmtotablegrocery.com	www.farmtotablegrocery.com
www.historyarchive.org	www.historyarchive.org
www.moviestream.net	www.moviestream.net
www.farmersmarketplace.com	www.farmersmarketplace.com
www.artfinds.com	www.artfinds.com
www.digitalworldwide.com	www.digitalworldwide.com
www.sportsmart.com	www.sportsmart.com
www.cookingbloggers.net	www.cookingbloggers.net
www.radiohub.com	www.radiohub.com
www.travelbuzz.co.in	www.travelbuzz.co.in
www.techsavvy.org	www.techsavvy.org
www.essentialstationery.ca	www.essentialstationery.ca
www.retrotrends.com	www.retrotrends.com
www.thoughtbubble.news	www.thoughtbubble.news
www.fitnesszone.rocks	www.fitnesszone.rocks
www.decorify.me	www.decorify.me
www.chocolateshop.com	www.chocolateshop.com
www.nasa.gov	www.nasa.gov
www.bestburgerjoint.com	www.bestburgerjoint.com
www.outdooradventures.net	www.outdooradventures.net
www.ticketexchange.com	www.ticketexchange.com
www.animalrescue.org	www.animalrescue.org
www.freesoftwarehub.com	www.freesoftwarehub.com
www.mybankingapp.com	www.mybankingapp.com
www.rosettastone.com	www.rosettastone.com
www.newsportal.net	www.newsportal.net
www.petsareawesome.com	www.petsareawesome.com
www.musicfestivaltickets.co	www.musicfestivaltickets.co
www.supermegastore.eu	www.supermegastore.eu
www.linguaexpertise.net	www.linguaexpertise.net
www.freshfoodguru.com	www.freshfoodguru.com
www.polyglotplanet.com	www.polyglotplanet.com
www.brainchallenge.net	www.brainchallenge.net
www.movielistings.net	www.movielistings.net
www.cookingblog.org	www.cookingblog.org
www.flycheap.com	www.flycheap.com
www.modernhomedecor.com	www.modernhomedecor.com
www.healthyfoodtips.net	www.healthyfoodtips.net
www.hikeroutes.eu	www.hikeroutes.eu
www.thestylezone.co.uk	www.thestylezone.co.uk
www.onlineconferencehub.com	www.onlineconferencehub.com
www.gadgetreviewer.com	www.gadgetreviewer.com
www.healthclinic.com	www.healthclinic.com
www.royalpoker.net	www.royalpoker.net
www.electronicssale.com	www.electronicssale.com
www.newsoutlet.co.nz	www.newsoutlet.co.nz
www.designerstore.com	www.designerstore.com
www.sportsgearusa.com	www.sportsgearusa.com
www.thetimesnews.com	www.thetimesnews.com
www.giftstore.net	www.giftstore.net
www.travelbugadventures.com	www.travelbugadventures.com
www.rentnowcar.com	www.rentnowcar.com
www.fashionblog.com	www.fashionblog.com
www.vacationplanner.com	www.vacationplanner.com
www.artinspiration.net	www.artinspiration.net
www.healthyrecipes.org	www.healthyrecipes.org
www.discountfurniture.co	www.discountfurniture.co
www.nfl.com	www.nfl.com
www.flightcompare.uk	www.flightcompare.uk
www.investmenttips.info	www.investmenttips.info
www.beatdrop.com	www.beatdrop.com
www.modernhomefurnishings.com	www.modernhomefurnishings.com
www.cookinggenius.org	www.cookinggenius.org
www.stylecrush.co	www.stylecrush.co
www.jobsearchnow.com	www.jobsearchnow.com
www.techreview.com	www.techreview.com
www.trivago.com	www.trivago.com
www.clothesforyou.net	www.clothesforyou.net
www.espn.com	www.espn.com
www.codeacademy.com	www.codeacademy.com
www.zillow.com	www.zillow.com
www.eatingwell.com	www.eatingwell.com
www.pinterest.com/cookingideas	www.pinterest.com/cookingideas
www.lonelyplanet.com	www.lonelyplanet.com
www.greenstore.com	www.greenstore.com
www.musicacademy.net	www.musicacademy.net
www.sciencenews.com	www.sciencenews.com
www.foodiebloggers.net	www.foodiebloggers.net
www.cinemaphile.org	www.cinemaphile.org
www.stocksmarketanalysis.com	www.stocksmarketanalysis.com
www.supportcenter.us	www.supportcenter.us
www.adventuretravelsolutions.com	www.adventuretravelsolutions.com
www.sportsstore.eu	www.sportsstore.eu
www.lingualearning.com	www.lingualearning.com
www.styleblog.net	www.styleblog.net
www.electrodeals.ca	www.electrodeals.ca
www.deliciousrecipes.net	www.deliciousrecipes.net
www.newsportal.com	www.newsportal.com
www.craftyideas.com	www.craftyideas.com
www.productregistration.info	www.productregistration.info
www.gamersparadise.net	www.gamersparadise.net
www.origamitutorials.com	www.origamitutorials.com
www.jobsearchengine.com	www.jobsearchengine.com
www.cheapflights.net	www.cheapflights.net
www.gamerzone.net	www.gamerzone.net
www.homebargains.co.uk	www.homebargains.co.uk
www.sportscenter.com	www.sportscenter.com
www.travelpalace.com	www.travelpalace.com
www.beautyvlogs.com	www.beautyvlogs.com
www.schoolsupplies.info	www.schoolsupplies.info
www.cookingcorner.com	www.cookingcorner.com
www.snackboxdelivery.com	www.snackboxdelivery.com
www.petshopexpress.co.uk	www.petshopexpress.co.uk
www.travelnationworldwide.com	www.travelnationworldwide.com
www.investorhub.com	www.investorhub.com
www.artisanjewelrycollection.com	www.artisanjewelrycollection.com
www.hollywoodgossips.com	www.hollywoodgossips.com
www.fitnessexperience.com	www.fitnessexperience.com
www.techbuzzblog.com	www.techbuzzblog.com
www.shoppingzone.net	www.shoppingzone.net
www.flyaway.com	www.flyaway.com
www.fitlife.co	www.fitlife.co
www.cookbookcorner.com	www.cookbookcorner.com
www.globalnewsfeed.org	www.globalnewsfeed.org
www.jobfinderpros.com	www.jobfinderpros.com
www.findlawyers.us	www.findlawyers.us
www.exploreworlds.net	www.exploreworlds.net
www.footwearstore.ca	www.footwearstore.ca
www.artworldshop.com	www.artworldshop.com
www.projectmanagementtool.com	www.projectmanagementtool.com
www.ecomatters.org	www.ecomatters.org
www.stylingfashionista.com	www.stylingfashionista.com
www.cakesandbakes.net	www.cakesandbakes.net
www.beautyavenue.co	www.beautyavenue.co
www.officemania.com	www.officemania.com
www.musictechhub.com	www.musictechhub.com
www.stylekings.com	www.stylekings.com
www.gymfreaks.org	www.gymfreaks.org
www.sportspage.net	www.sportspage.net
www.gardeningtipsandtricks.com	www.gardeningtipsandtricks.com
www.creativecrafts.org	www.creativecrafts.org
www.jokesrus.com	www.jokesrus.com
www.healthylivingtips.net	www.healthylivingtips.net
www.artisanaljewelry.com	www.artisanaljewelry.com
www.bestproductsincorporated.com	www.bestproductsincorporated.com
www.foodcriticsreview.com	www.foodcriticsreview.com
www.diycommunity.com	www.diycommunity.com
www.rescueanimals.org	www.rescueanimals.org
www.greenenergynews.net	www.greenenergynews.net
www.fashionforward.com	www.fashionforward.com
www.boxofficesales.com	www.boxofficesales.com
www.homecookingchef.com	www.homecookingchef.com
www.supermarket.net	www.supermarket.net
www.rentalcar.com	www.rentalcar.com
www.craftcoffeehouse.org	www.craftcoffeehouse.org
www.technewsblog.net	www.technewsblog.net
www.flynow.com	www.flynow.com
www.japantravelguide.jp	www.japantravelguide.jp
www.budgetcookingblog.com	www.budgetcookingblog.com
www.scientificamerica.net	www.scientificamerica.net
www.hieroglyphs.net	www.hieroglyphs.net
www.gamingworld.com	www.gamingworld.com
www.travelcheap.com	www.travelcheap.com
www.fittrackerapp.com	www.fittrackerapp.com
www.sustainablelivingstore.co.uk	www.sustainablelivingstore.co.uk
www.cookingdelightful.com	www.cookingdelightful.com
www.bookhunters.com	www.bookhunters.com
www.historychannelplay.com	www.historychannelplay.com
www.bestbeautysalon.net	www.bestbeautysalon.net
www.technews.com	www.technews.com
www.fashionista.co.jp	www.fashionista.co.jp
www.connectfriends.net	www.connectfriends.net
www.traveladvisor.com	www.traveladvisor.com
www.onlineelectronicsstore.net	www.onlineelectronicsstore.net
www.deliciousrecipes.com	www.deliciousrecipes.com
www.musicstreaming.com	www.musicstreaming.com
www.cheaptraveldeals.net	www.cheaptraveldeals.net
www.fittracker.io	www.fittracker.io
www.entertainmentbuzz.net	www.entertainmentbuzz.net
www.makeupworld.com	www.makeupworld.com
www.linguatutor.net	www.linguatutor.net
www.cookingdiaries.org	www.cookingdiaries.org
www.jobsearchhub.co.uk	www.jobsearchhub.co.uk
www.flighttracker.net	www.flighttracker.net
www.thecleaneatingclub.com	www.thecleaneatingclub.com
www.hotelworld.com	www.hotelworld.com
www.tunespotify.com	www.tunespotify.com
www.quirkysouvenirs.co.nz	www.quirkysouvenirs.co.nz
www.styleguru.com	www.styleguru.com
www.foodguide.com	www.foodguide.com
www.fitnesstraineronline.com	www.fitnesstraineronline.com
www.stationerygeeks.com	www.stationerygeeks.com
www.furniture4u.com	www.furniture4u.com
www.medicalsupplies.net	www.medicalsupplies.net
www.yogainspiration.com	www.yogainspiration.com
www.cateringqueen.co.nz	www.cateringqueen.co.nz
www.stayherehotels.com	www.stayherehotels.com
www.detailersdepot.com	www.detailersdepot.com
www.streamsongs.com	www.streamsongs.com
www.sharetogether.net	www.sharetogether.net
www.fitguideapp.net	www.fitguideapp.net
www.homedecorinspo.com	www.homedecorinspo.com
www.currentlynews.com	www.currentlynews.com
www.rebrandingideas.com	www.rebrandingideas.com
www.funnycatvideos.net	www.funnycatvideos.net
www.foodytutorials.com	www.foodytutorials.com
www.cloudstoragehub.co	www.cloudstoragehub.co
www.onlinetutoringacademy.co.uk	www.onlinetutoringacademy.co.uk
www.thetechupdate.com	www.thetechupdate.com
www.travelhacks.com	www.travelhacks.com
www.ticketpop.com	www.ticketpop.com
www.cafedeli.com	www.cafedeli.com
www.oliviapaints.net	www.oliviapaints.net
www.fitgearstore.ca	www.fitgearstore.ca
www.styleshoppe.com	www.styleshoppe.com
www.pizzalandonline.com	www.pizzalandonline.com
www.astronewsfeed.com	www.astronewsfeed.com
www.weatherworld.co.uk	www.weatherworld.co.uk
www.techconnect.com	www.techconnect.com
www.randomwebsitegenerator.com	www.randomwebsitegenerator.com
www.playtimezone.com	www.playtimezone.com
www.pinterest.com	www.pinterest.com
www.reuters.com	www.reuters.com
www.apartments.net	www.apartments.net
www.petco.com	www.petco.com
www.amazon.co.uk	www.amazon.co.uk
www.bodybuilding.com/forum	www.bodybuilding.com/forum
www.forbes.com	www.forbes.com
www.expedia.com	www.expedia.com
www.beachresort.com	www.beachresort.com
www.onlinelearning.org	www.onlinelearning.org
www.etsyshop.ca	www.etsyshop.ca
www.thoughtfulmusings.net	www.thoughtfulmusings.net
www.ecofriendlyclothing.co	www.ecofriendlyclothing.co
www.cookingtools.eu	www.cookingtools.eu
www.eventslistings.net	www.eventslistings.net
www.petstoreusa.com	www.petstoreusa.com
www.cnn.com	www.cnn.com
www.eyebuydirect.com	www.eyebuydirect.com
www.behance.net	www.behance.net
www.bloglovin.com	www.bloglovin.com
www.instagram.com	www.instagram.com
www.linkedin.com	www.linkedin.com
www.imdb.com	www.imdb.com
www.techdeals.usa	www.techdeals.usa
www.greenfarmer.org	www.greenfarmer.org
www.thetimesonline.com	www.thetimesonline.com
www.findaplumber.com	www.findaplumber.com
www.pawsonline.com	www.pawsonline.com
www.gymtime.com	www.gymtime.com
www.travelworld.net	www.travelworld.net
www.officemart.co.nz	www.officemart.co.nz
www.udemy.com	www.udemy.com
www.techzone.com	www.techzone.com
www.zara.com	www.zara.com
www.expedia.ca	www.expedia.ca
www.lifestylenews.net	www.lifestylenews.net
www.artgallery.com	www.artgallery.com
www.fashionista.co	www.fashionista.co
www.fitnessexperts.org	www.fitnessexperts.org
www.loversparadise.com	www.loversparadise.com
www.techcareeradvice.com	www.techcareeradvice.com
www.yummycookingtips.com	www.yummycookingtips.com
www.travelguides.com	www.travelguides.com
www.giftsforhimher.com	www.giftsforhimher.com
www.travelaway.net	www.travelaway.net
www.budgethomefurnishings.com	www.budgethomefurnishings.com
www.petloversunite.com	www.petloversunite.com
www.fitnesszone.co.nz	www.fitnesszone.co.nz
www.madewithloveartisans.com	www.madewithloveartisans.com
www.bakeitupnow.com	www.bakeitupnow.com
www.chefskitchen.com	www.chefskitchen.com
www.jetsetaway.co.nz	www.jetsetaway.co.nz
www.footwearusa.com	www.footwearusa.com
www.educateyourself.net	www.educateyourself.net
www.greenfingersmarketplace.org	www.greenfingersmarketplace.org
www.dailynewsupdate.com	www.dailynewsupdate.com
www.galleriaartworks.com	www.galleriaartworks.com
www.livingroomdesigns.com.au	www.livingroomdesigns.com.au
www.launchstartupguide.com	www.launchstartupguide.com
www.fitfinder.com	www.fitfinder.com
www.cookbookcentral.net	www.cookbookcentral.net
www.streamitnow.org	www.streamitnow.org
www.ecommercesolutions.com	www.ecommercesolutions.com
www.gigguide.net	www.gigguide.net
www.homedecorzone.co.nz	www.homedecorzone.co.nz
www.jobsearching101.com	www.jobsearching101.com
www.buzzfeed.org	www.buzzfeed.org
www.bytepress.net	www.bytepress.net
www.boxline.com	www.boxline.com
www.basketcart.com	www.basketcart.com
www.backpackerweb.com	www.backpackerweb.com
www.brainstormsolutions.co.uk	www.brainstormsolutions.co.uk
www.bohemianthreads.com	www.bohemianthreads.com
www.beautybox.com	www.beautybox.com
www.travelhub.com	www.travelhub.com
www.thetimes.ng	www.thetimes.ng
www.plantbasedrecipes.net	www.plantbasedrecipes.net
www.gorgeousgowns.co.nz	www.gorgeousgowns.co.nz
www.laughoutloudtv.tv	www.laughoutloudtv.tv
www.learnfromhome.org	www.learnfromhome.org
www.travelplanner.com	www.travelplanner.com
www.thecrimefiles.net	www.thecrimefiles.net
www.artisticmind.com	www.artisticmind.com
www.deliveryfoodapp.com	www.deliveryfoodapp.com
www.gigboard.com	www.gigboard.com
www.stockmarketpros.com	www.stockmarketpros.com
www.cheapflightdeals.net	www.cheapflightdeals.net
www.handmadejewelryco.com	www.handmadejewelryco.com
www.jobsearchengine.co.uk	www.jobsearchengine.co.uk
www.globetrottertales.com	www.globetrottertales.com
www.newschannel.net	www.newschannel.net
www.cookingmagazine.com	www.cookingmagazine.com
www.usedcarsales.co.uk	www.usedcarsales.co.uk
www.indiefest.com	www.indiefest.com
www.hotelbooking.com	www.hotelbooking.com
www.futuresightinvestments.net	www.futuresightinvestments.net
www.fitnessequipmentworld.com	www.fitnessequipmentworld.com
www.financeblogs.net	www.financeblogs.net
www.feetfashion.com	www.feetfashion.com
www.traveltips.com	www.traveltips.com
www.technewsfeed.com	www.technewsfeed.com
www.handcraftedjewels.com	www.handcraftedjewels.com
www.tripadvisor.com	www.tripadvisor.com
www.greenlivingblog.com	www.greenlivingblog.com
www.tasteitaly.com	www.tasteitaly.com
www.adventureguide.net	www.adventureguide.net
www.cinemaxonline.com	www.cinemaxonline.com
www.flycheapnow.com	www.flycheapnow.com
www.builditfromscratch.com	www.builditfromscratch.com
www.elegantbridalboutique.com	www.elegantbridalboutique.com
www.freshmarketplace.com	www.freshmarketplace.com
www.techworldsummit.com	www.techworldsummit.com
www.chilloutgaming.com	www.chilloutgaming.com
www.cookbook.net	www.cookbook.net
www.businesstimes.com	www.businesstimes.com
www.musiclibrary.org	www.musiclibrary.org
www.travelgov.com	www.travelgov.com
www.styleguide.co	www.styleguide.co
www.hostingpros.net	www.hostingpros.net
www.homeimprovementtips.com	www.homeimprovementtips.com
www.giftideas.net	www.giftideas.net
www.healthyliving.com	www.healthyliving.com
www.datingapp.com	www.datingapp.com
www.grocerystore.net	www.grocerystore.net
www.jobportal.org	www.jobportal.org
www.animalpictures.com	www.animalpictures.com
www.homestore.co.nz	www.homestore.co.nz
www.photographyblog.com	www.photographyblog.com
www.cookingwebsite.info	www.cookingwebsite.info
www.fashionablyyours.com	www.fashionablyyours.com
www.travelagency.ca	www.travelagency.ca
www.productreview.com	www.productreview.com
www.sewingdesigns.net	www.sewingdesigns.net
www.healthyfoodblog.com	www.healthyfoodblog.com
www.freshsmilesclinic.net	www.freshsmilesclinic.net
www.flylowcostairlines.com	www.flylowcostairlines.com
www.modernhomefurnitureshop.com	www.modernhomefurnitureshop.com
www.technewsportal.com	www.technewsportal.com
www.urbanstyleco.com	www.urbanstyleco.com
www.japantravelguide.co	www.japantravelguide.co
www.cityapartmentfinder.com	www.cityapartmentfinder.com
www.sneakerworldstore.com	www.sneakerworldstore.com
www.bonton.com	www.bonton.com
www.bookingbargains.net	www.bookingbargains.net
www.bakingchamp.com	www.bakingchamp.com
www.busuu.com	www.busuu.com
www.boxofficebio.com	www.boxofficebio.com
www.berkeleyartisans.com	www.berkeleyartisans.com
www.bodyluxeusa.com	www.bodyluxeusa.com
www.beautybythebay.com	www.beautybythebay.com
www.veganrecipes.net	www.veganrecipes.net
www.electronicstore.ca	www.electronicstore.ca
www.flightfinder.co.uk	www.flightfinder.co.uk
www.journalarchive.org	www.journalarchive.org
www.traveltales.com	www.traveltales.com
www.discountdecor.com	www.discountdecor.com
www.todolistapp.com	www.todolistapp.com
www.yogawithadriene.com	www.yogawithadriene.com
www.sitedesignerpro.com	www.sitedesignerpro.com
www.newsupdate.net	www.newsupdate.net
www.cheaptravel.org	www.cheaptravel.org
www.insurancequotehub.com	www.insurancequotehub.com
www.shoestoreonline.com	www.shoestoreonline.com
www.vacationreviewer.com	www.vacationreviewer.com
www.indiemusicstream.com	www.indiemusicstream.com
www.decorworld.com	www.decorworld.com
www.healthtracker.com	www.healthtracker.com
www.travelworldwide.org	www.travelworldwide.org
www.newstoday.com	www.newstoday.com
www.techdeals.net	www.techdeals.net
www.cookingcornerblog.com	www.cookingcornerblog.com
www.petcarecentral.com	www.petcarecentral.com
www.dictionarylookup.org	www.dictionarylookup.org
www.localfarmersmarket.co.uk	www.localfarmersmarket.co.uk
www.foodblog.com	www.foodblog.com
www.travelagency.net	www.travelagency.net
www.newschannel.com	www.newschannel.com
www.stylehub.co	www.stylehub.co
www.homestore.com	www.homestore.com
www.petshoponline.com	www.petshoponline.com
www.apartmentfinder.com	www.apartmentfinder.com
www.craftingideas.com	www.craftingideas.com
www.photoprintingcompany.co.uk	www.photoprintingcompany.co.uk
www.jobboardpros.com	www.jobboardpros.com
www.thetimes.co.uk	www.thetimes.co.uk
www.ign.com	www.ign.com
www.mint.com	www.mint.com
www.laughhub.net	www.laughhub.net
www.fitfreaks.net	www.fitfreaks.net
www.newsline.co	www.newsline.co
www.planmytrip.com	www.planmytrip.com
www.shopaholic.com	www.shopaholic.com
www.geekcentral.us	www.geekcentral.us
www.squaretiles.net	www.squaretiles.net
www.bikes4everyone.com	www.bikes4everyone.com
www.codecademy.com	www.codecademy.com
www.techreviewsblog.com	www.techreviewsblog.com
www.webdesignpros.io	www.webdesignpros.io
www.cookinghub.net	www.cookinghub.net
www.traveldeals.com	www.traveldeals.com
www.breakingnewsfeed.com	www.breakingnewsfeed.com
www.ezdiyprojects.com	www.ezdiyprojects.com
www.healthylivingtips.org	www.healthylivingtips.org
www.bikepartscentral.com	www.bikepartscentral.com
www.myfashionlookbook.com	www.myfashionlookbook.com
www.authorpage.com	www.authorpage.com
www.musicboxoffice.com	www.musicboxoffice.com
www.travelmate.com	www.travelmate.com
www.coffeelovershop.com	www.coffeelovershop.com
www.hikingadventures.com	www.hikingadventures.com
www.workoutbuddyapp.com	www.workoutbuddyapp.com
www.onlinegreencourses.com	www.onlinegreencourses.com
www.artsyfashionstore.com	www.artsyfashionstore.com
www.musicbuzz.net	www.musicbuzz.net
www.flowerworld.com	www.flowerworld.com
www.laptopkingdom.com	www.laptopkingdom.com
www.calmzone.net	www.calmzone.net
www.trendystyle.co.nz	www.trendystyle.co.nz
www.travelguidesonline.com	www.travelguidesonline.com
www.fitnesshub.co.uk	www.fitnesshub.co.uk
www.bizwebbuilder.com	www.bizwebbuilder.com
www.masterchefschool.com	www.masterchefschool.com
www.homedecor.com	www.homedecor.com
www.lifestylebeautyblog.net	www.lifestylebeautyblog.net
www.cookingwithlove.co	www.cookingwithlove.co
www.languagelearninghub.com	www.languagelearninghub.com
www.relaxingretreats.co	www.relaxingretreats.co
www.trendingapp.net	www.trendingapp.net
www.etsyshop.com	www.etsyshop.com
www.tweety.com	www.tweety.com
www.cookingwebsite.org	www.cookingwebsite.org
www.vintageclothingstore.co.nz	www.vintageclothingstore.co.nz
www.wanderlustexplorers.com	www.wanderlustexplorers.com
www.chocolateshoppeonline.com	www.chocolateshoppeonline.com
www.cyclisthaven.co.uk	www.cyclisthaven.co.uk
www.hgtvhandmade.com	www.hgtvhandmade.com
www.bankingapp.com	www.bankingapp.com
www.runningshoes.com	www.runningshoes.com
www.masterchefrecipes.com	www.masterchefrecipes.com
www.fashiontrendz.co.nz	www.fashiontrendz.co.nz
www.lonelyplanetguide.com	www.lonelyplanetguide.com
www.petcaretips.com	www.petcaretips.com
www.winewonders.com	www.winewonders.com
www.financialplanners101.com	www.financialplanners101.com
www.studyaid.org	www.studyaid.org
www.cookbookusa.net	www.cookbookusa.net
www.quirkyfinds.co.nz	www.quirkyfinds.co.nz
www.fashionbargain.biz	www.fashionbargain.biz
www.bestlaptopsales.ca	www.bestlaptopsales.ca
www.gameonfanshop.com	www.gameonfanshop.com
www.myprojecttracker.com	www.myprojecttracker.com
www.medicalnewsnow.com	www.medicalnewsnow.com
www.thecinemacritic.net	www.thecinemacritic.net
www.listentothis.com	www.listentothis.com
www.lifestyleblog.com	www.lifestyleblog.com
www.filmfanatic.net	www.filmfanatic.net
www.healthyfoodideas.com	www.healthyfoodideas.com
www.fashionfinds.com	www.fashionfinds.com
www.gardeningtips.net	www.gardeningtips.net
www.streamcompare.com	www.streamcompare.com
www.writeaway.com	www.writeaway.com
www.glamattire.com	www.glamattire.com
www.canvascreations.net	www.canvascreations.net
www.furnituresale.ca	www.furnituresale.ca
www.japanstay.com	www.japanstay.com
www.plantbasedcooking.com	www.plantbasedcooking.com
www.zenplay.com	www.zenplay.com
www.streamflix.tv	www.streamflix.tv
www.luminatech.co	www.luminatech.co
www.fashionstyle.com	www.fashionstyle.com
www.travelguide.net	www.travelguide.net
www.newsupdate.org	www.newsupdate.org
www.furnituremax.com	www.furnituremax.com
www.fitnessempire.co.uk	www.fitnessempire.co.uk
www.petloversclub.com	www.petloversclub.com
www.glowingface.net	www.glowingface.net
www.sweettooth.com	www.sweettooth.com
www.lenseup.com	www.lenseup.com
www.modernoffice.co	www.modernoffice.co
www.cityname.gov	www.cityname.gov
www.outdooradventure.com	www.outdooradventure.com
www.petrescues.org	www.petrescues.org
www.wanderlustmagazine.com	www.wanderlustmagazine.com
www.beautyhaven.co.nz	www.beautyhaven.co.nz
www.animalrescuecentre.org	www.animalrescuecentre.org
www.fitbodzone.com	www.fitbodzone.com
www.yummyfoodblog.com	www.yummyfoodblog.com
www.artcollectiveonline.com	www.artcollectiveonline.com
www.wikipedia.org	www.wikipedia.org
www.amazon.com	www.amazon.com
www.indeed.com	www.indeed.com
www.netflix.com	www.netflix.com
www.kenrockwell.com	www.kenrockwell.com
www.booking.com	www.booking.com
www.etsy.com	www.etsy.com
www.cheapflights.com	www.cheapflights.com
www.artgallery.co.uk	www.artgallery.co.uk
www.electronicsworld.net	www.electronicsworld.net
www.nature.com	www.nature.com
www.travelsavings.com	www.travelsavings.com
www.gourmetgrocery.net	www.gourmetgrocery.net
www.handtoolsupply.com	www.handtoolsupply.com
www.funnypetvideos.net	www.funnypetvideos.net
www.healthyfooddelivery.com	www.healthyfooddelivery.com
www.solesistershoes.com	www.solesistershoes.com
www.vintagevinylrecords.com	www.vintagevinylrecords.com
www.artisansoapcompany.com	www.artisansoapcompany.com
www.techbrothers.com	www.techbrothers.com
www.cookingmadeeasy.com	www.cookingmadeeasy.com
www.greenthumbtips.net	www.greenthumbtips.net
www.fitnesshub.co	www.fitnesshub.co
www.clothingcorner.com	www.clothingcorner.com
www.outdooradventuresupply.com	www.outdooradventuresupply.com
www.handytools.com	www.handytools.com
www.filmcentral.com	www.filmcentral.com
www.bestrecipes.net	www.bestrecipes.net
www.travelbloggersguide.com	www.travelbloggersguide.com
www.craftymom.com	www.craftymom.com
www.techcrunch.com	www.techcrunch.com
www.beautycarehub.co.in	www.beautycarehub.co.in
www.happypawsclub.ca	www.happypawsclub.ca
www.chicboutique.com	www.chicboutique.com
www.cinematech.net	www.cinematech.net
www.footlocker.com	www.footlocker.com
www.homefurnishers.co.nz	www.homefurnishers.co.nz
www.fashionista365.com	www.fashionista365.com
www.dailynewsreporter.org	www.dailynewsreporter.org
www.techstore.com	www.techstore.com
www.greenlifestylemarketplace.com	www.greenlifestylemarketplace.com
www.myaccountantonline.com	www.myaccountantonline.com
www.techreviews.net	www.techreviews.net
www.exploremaps.org	www.exploremaps.org
www.healthytipsblog.com	www.healthytipsblog.com
www.handymanhelper.net	www.handymanhelper.net
www.lensmasters.com	www.lensmasters.com
www.gamingzone.com	www.gamingzone.com
www.financialtimes.co	www.financialtimes.co
www.musicjournal.com	www.musicjournal.com
www.globaltraveler.net	www.globaltraveler.net
www.tastybite.com	www.tastybite.com
www.websitemaker.org	www.websitemaker.org
www.furryfriends.co.nz	www.furryfriends.co.nz
www.clothingstoreusa.com	www.clothingstoreusa.com
www.applyuniversity.com	www.applyuniversity.com
www.stayinparadise.com	www.stayinparadise.com
www.newsreporter.com	www.newsreporter.com
www.groceryhub.com	www.groceryhub.com
www.sportsgearworldwide.net	www.sportsgearworldwide.net
www.handmademarketplace.com	www.handmademarketplace.com
www.codelearn.com	www.codelearn.com
www.chitchat.com	www.chitchat.com
www.futuristdailynews.com	www.futuristdailynews.com
www.homedecorideas.co.uk	www.homedecorideas.co.uk
www.stationerystoreonline.com	www.stationerystoreonline.com
www.nationalgeographic.org	www.nationalgeographic.org
www.flyhub.com	www.flyhub.com
www.fashionzone.co.nz	www.fashionzone.co.nz
www.imagination.com	www.imagination.com
www.cookinggalore.net	www.cookinggalore.net
www.podcastmania.com	www.podcastmania.com
www.movielink.org	www.movielink.org
www.traveltopia.com	www.traveltopia.com
www.globenews24.com	www.globenews24.com
www.codetropolis.com	www.codetropolis.com
www.languagehelpcenter.com	www.languagehelpcenter.com
www.webmd.com	www.webmd.com
www.bandcamp.com	www.bandcamp.com
www.airbnb.com	www.airbnb.com
www.mycupcakery.net	www.mycupcakery.net
www.steamcommunity.com	www.steamcommunity.com
www.adventuretime.com	www.adventuretime.com
www.artsyshop.co	www.artsyshop.co
www.hardwareworld.com	www.hardwareworld.com
www.bakerydelights.com	www.bakerydelights.com
www.animalhaven.org	www.animalhaven.org
www.chicstylemagazine.com	www.chicstylemagazine.com
www.musicworldwide.co.uk	www.musicworldwide.co.uk
www.foodblog.net	www.foodblog.net
www.everythingonlinestore.com	www.everythingonlinestore.com
www.companyname.com	www.companyname.com
www.photographyhub.com	www.photographyhub.com
www.languagelearning.com	www.languagelearning.com
www.fitnesstipsandtricks.com	www.fitnesstipsandtricks.com
www.weatherforecast.net	www.weatherforecast.net
www.greenfingers.co.uk	www.greenfingers.co.uk
www.flightsearchengine.org	www.flightsearchengine.org
www.consumerfeedbacks.com	www.consumerfeedbacks.com
www.programmingtutorials.net	www.programmingtutorials.net
www.clothesgalore.com	www.clothesgalore.com
www.codeworks.edu	www.codeworks.edu
www.netflixshows.com	www.netflixshows.com
www.marketingtipsblog.io	www.marketingtipsblog.io
www.travelsites.com	www.travelsites.com
www.wordpress.com	www.wordpress.com
www.paperplanet.com	www.paperplanet.com
www.moneyonlinebanking.com	www.moneyonlinebanking.com
www.healthyoga.com	www.healthyoga.com
www.dailynewsfeed.net	www.dailynewsfeed.net
www.artgalleryhub.co	www.artgalleryhub.co
www.furniturestoreworld.com	www.furniturestoreworld.com
www.deliciouscookingrecipes.com	www.deliciouscookingrecipes.com
www.boxofficemovies.com	www.boxofficemovies.com
www.travelexploreworldwide.com	www.travelexploreworldwide.com
www.careerconnectjobs.com	www.careerconnectjobs.com
www.thediscountshopper.net	www.thediscountshopper.net
www.tourismguide.net	www.tourismguide.net
www.handmadecrafts.in	www.handmadecrafts.in
www.sciencemag.org	www.sciencemag.org
www.homestylingideas.com	www.homestylingideas.com
www.eventbookings.com	www.eventbookings.com
www.bakinginstructor.co.uk	www.bakinginstructor.co.uk
www.hotelspain.eu	www.hotelspain.eu
www.crafts.com	www.crafts.com
www.soccernews.net	www.soccernews.net
www.gamezone.io	www.gamezone.io
www.jobsearchhub.com	www.jobsearchhub.com
www.astrology101.co	www.astrology101.co
www.fashiontrendz.com	www.fashiontrendz.com
www.recipebox.com	www.recipebox.com
www.headlinenews.net	www.headlinenews.net
www.artstore.ca	www.artstore.ca
www.greenthumb.com	www.greenthumb.com
www.farmfreshmarket.com	www.farmfreshmarket.com
www.homedecorideas.com	www.homedecorideas.com
www.foodbloggerpro.co	www.foodbloggerpro.co
www.weatherupdate.org	www.weatherupdate.org
www.footwearworld.com	www.footwearworld.com
www.jobfinder.net	www.jobfinder.net
www.hikinggearstore.com	www.hikinggearstore.com
www.reliablesource.org	www.reliablesource.org
www.romanticretreats.net	www.romanticretreats.net
www.expresspassportrenewal.com	www.expresspassportrenewal.com
www.artistsnetwork.com	www.artistsnetwork.com
www.asiatraveltips.com	www.asiatraveltips.com
www.craftyfingers.com	www.craftyfingers.com
www.petloversclub.net	www.petloversclub.net
www.uncommongoods.com	www.uncommongoods.com
www.beautydiscounts.org	www.beautydiscounts.org
www.adventureseeker.com	www.adventureseeker.com
www.artsliveentertainment.com	www.artsliveentertainment.com
www.creativelab.net	www.creativelab.net
www.foodieheaven.com	www.foodieheaven.com
www.fitlifeapp.com	www.fitlifeapp.com
www.giftsgalore.com	www.giftsgalore.com
www.taxhelpnow.com	www.taxhelpnow.com
www.greenworldalliance.org	www.greenworldalliance.org
www.fashionista.net	www.fashionista.net
www.getfitnow.org	www.getfitnow.org
www.careerfinder.co.uk	www.careerfinder.co.uk
www.vintagefinds.com	www.vintagefinds.com
www.amazon.ca	www.amazon.ca
www.beautyguru.com	www.beautyguru.com
www.artfilm.org	www.artfilm.org
www.fitzone.com	www.fitzone.com
www.pastaroma.co.uk	www.pastaroma.co.uk
www.gadgetworld.net	www.gadgetworld.net
www.languagehub.com	www.languagehub.com
www.luxurybeauty.com	www.luxurybeauty.com
www.homedepot4u.com	www.homedepot4u.com
www.weatherreport.com	www.weatherreport.com
www.fashiontrends.net	www.fashiontrends.net
www.flightsnow.co.nz	www.flightsnow.co.nz
www.recipes365.com	www.recipes365.com
www.thebandmusic.uk	www.thebandmusic.uk
www.knowledgehub.edu	www.knowledgehub.edu
www.rentalcars24.fr	www.rentalcars24.fr
www.pawspalace.com	www.pawspalace.com
www.volunteeringworld.org	www.volunteeringworld.org
www.careersfinder.us	www.careersfinder.us
www.recipesgalore.com	www.recipesgalore.com
www.tokyotower.jp	www.tokyotower.jp
www.dressup.com	www.dressup.com
www.jobsearcher.io	www.jobsearcher.io
www.artworksonline.com	www.artworksonline.com
www.officemart.com	www.officemart.com
www.clothesforyou.co.nz	www.clothesforyou.co.nz
www.mymeditatehub.com	www.mymeditatehub.com
www.foodbloggers.net	www.foodbloggers.net
www.streamnow.tv	www.streamnow.tv
www.carswap.co.nz	www.carswap.co.nz
www.musicstore.jp	www.musicstore.jp
www.letsgotravel.info	www.letsgotravel.info
www.learnspanishonline.mx	www.learnspanishonline.mx
www.freelancermarketplace.org	www.freelancermarketplace.org
www.photobloggers.com	www.photobloggers.com
www.makeupworld.us	www.makeupworld.us
www.myjourney.blog	www.myjourney.blog
www.scholarshipfinder.org	www.scholarshipfinder.org
www.pawsomepetstore.com	www.pawsomepetstore.com
www.homestylemagazine.com	www.homestylemagazine.com
www.playfantasyworld.com	www.playfantasyworld.com
www.musicmp3store.com	www.musicmp3store.com
www.cookingwithlove.com	www.cookingwithlove.com
www.freshmarket.com	www.freshmarket.com
www.styleconnect.com	www.styleconnect.com
www.burgertownusa.net	www.burgertownusa.net
www.sweetpetalsgifts.com	www.sweetpetalsgifts.com
www.traveldestinationguide.net	www.traveldestinationguide.net
www.gemstonegalore.com	www.gemstonegalore.com
www.techsavvyshopper.com	www.techsavvyshopper.com
www.airwaysbooking.com	www.airwaysbooking.com
www.elegantinteriorsdesigns.com	www.elegantinteriorsdesigns.com
www.pawsandclawspetstore.com	www.pawsandclawspetstore.com
www.techworld.com	www.techworld.com
www.flowerpower.net	www.flowerpower.net
www.clearskiesrentals.com	www.clearskiesrentals.com
www.gourmetdelights.co.nz	www.gourmetdelights.co.nz
www.beautybuzz.com	www.beautybuzz.com
www.journeyplanner.com	www.journeyplanner.com
www.renewclothing.com	www.renewclothing.com
www.livemusicarena.com	www.livemusicarena.com
www.healthyfoodspot.com	www.healthyfoodspot.com
www.vintagecarhub.com	www.vintagecarhub.com
www.bestpetsupplies.co.nz	www.bestpetsupplies.co.nz
www.codingworlds.org	www.codingworlds.org
www.outdooradventuresales.ca	www.outdooradventuresales.ca
www.sunshinetravelco.com	www.sunshinetravelco.com
www.marketingmindsetacademy.com	www.marketingmindsetacademy.com
www.printyourtee.com	www.printyourtee.com
www.eventbrite.in	www.eventbrite.in
www.ecotips.net	www.ecotips.net
www.eaterydelight.com	www.eaterydelight.com
www.naturegetaway.co.nz	www.naturegetaway.co.nz
www.paperpicks.com	www.paperpicks.com
www.stylespotting.com	www.stylespotting.com
www.sciencedirect.org	www.sciencedirect.org
www.uncommoncharms.com	www.uncommoncharms.com
www.luxeproducts.shop	www.luxeproducts.shop
www.theverge.com	www.theverge.com
www.delishknowledge.com	www.delishknowledge.com
www.myfitnesspal.com	www.myfitnesspal.com
www.bbcnews.com	www.bbcnews.com
www.theknot.com	www.theknot.com
www.byrdie.com	www.byrdie.com
